And so what if it is a rebound relationship for both of you?	What if it is a rebound relationship for both of you?
Good luck in your search for the one!	Good luck in your search for your perfect match.
WHY DOES EVERYONE SEEM TO WANT SOMEONE THAT THEY CAN'T HAVE AND KNOW THAT THEY SHOULDN'T WANT.	Why does everyone seem to want someone that they cannot have and know that they should not want?
Do you like to argue and fight???	Do you like to argue and fight?
So if you're set on that, that's the way to go!!	If you are set on that, that is the way to go.
My ex of 3 years cheated.	I went out with my ex for three years and then he/she cheated.
Work at it but don't let him keep you locked up at home.	Work at it and do not let him keep you locked up at home.
>>Other than those two things, just ask him once in a while.	Other than two questions, ask him just once in awhile.
Also men get bored and tire way before woman do.	Also, men get bored and tired a long time before women do.
She's strong and loving and most of all...really wasn't as happy as she thought she was.	She is strong, loving, and wasn't as happy as she thought she was.
its one way of saying i don't like you!	It is another way to say that they don't like you.
King had a song about this - Only your Mother loves you (and see might be jiving too).	"King has a song about this, it is called ""Only Your Mother Loves You."""
He loves you, too, girl...Time will tell.	He loves you as well, but only time can tell what will happen.
he wants me to change how i look.	He wants me to change my appearance.
I know I have someone to come home to.	I relish the fact that I have someone to come home to.
did you fell goog because i want to have sex, but you have to be careful	Sex can feel great; but, you have to be careful.
you want all your friends forever?)	Do you want all your friends to be with you forever?
IT DOESN'T MEAN THAT YOU ARE SLUTTY.	It does not mean that you are a loose woman.
Going to a club and dancing.	You could try dancing at a club.
Don't go anywhere you went with him or her.	Do not go any place you went with him or her.
They're a lot of fun - there's plenty to do.	There is plenty to do and they are a lot of fun.
it all depends on when ur ready.	It all depends on when you are ready.
Stay 100 miles away from this guy.	Stay 100 miles away for this man.
Just be prepared cause if it happen once it can happen again!	You have to be prepared that if it happened one time, it can happen again.
I'm just looking for the girl who wants that time with me	I am looking for the girl who want to spend time with me.
Least not till he gets another girlfriend.	At least not until he gets another woman friend.
Wife says, We don't wear that shit.	"The wife says, ""We do not wear that."""
if you're asking, then you should break-up w/ and open yourself to other options.	If you are asking, then you should break up with him/her and then open yourself up to other options.
why do gays want to get married?	Why do homosexuals want to get married?
(saying sorry to him without commiting a mistake is humilation to ur self...AND DON'T EVER GET WEAK!!)	Do not apologize if you have not made a mistake.
do you have to rush your choice?	do you have to rush the choice?
THEY BOTH DONT RESPECT YOUR FEELING.	Both of them do not respect your feelings.
No seriously, think about howmany cocky girls are out there.	No seriously, think about how many arrogant women are out there.
She is too afraid to ask him out.	She is too shy to ask him out.
get a grip, how can you love someone that you don't even communicate with.	Get a brain, how can you love someone that you do not even communicate with.
i'd ask you out, but i live in Oregon and have no idea where you live...	I would ask you out, but I live in Oregon and have no idea where you live.
they have never proformed before and it doubles the plesure!	They have never performed before, and it doubles the pleasure.
i'll probably go and see one.	I will probably go and see one of them.
Either way, best of luck but I'm just glad that I have brown hair!!	In any case, I wish you best of luck although I am glad that I have brown hair.
Mail me a pick honorarius@yahoo.com and I will tell you...	Send me an e-mail at honorarius@yahoo.com, and I will let you know.
it is absolutely just a challenge!!!!!!!!!!!	It is absolutely a great challenge.
well-im  girl so ill help u out.	I am a girl so I am will to help you out.
Dont tell them but let them find out once your in bed with her.	Do not inform them but allow them to discover it once you are in bed with her.
if i would've kept my last name its just a freakin name.	If I would have kept my last name. It is merely a name.
i hardly everrr see him in school either usually i see hima t my brothers basketball games .	I rarely see him in school either, I typically see him at my brother's basketball games.
he's telling that to some gurls too... he's a womanizer..	He is stating that to some women as well. He is a Lothario.
DROP HIS BUTTT, THERE ARE PLENTY OF FISH IN THE SEA OF AMORE:0)	Leave him, there are plenty of men out there.
I know because I am just like your wife.	I know this because I have a similar personality to your wife.
when she calls, text her back	When she calls, text her back instead.
No way im 5`4 and he`s 6`2	No, I am 5ft 4inches and he is 6ft and 2inches.
Dont you know the number one rule, Trust No One.	Don't you know the cardinal rule is to never trust anyone?
we've tried breakin up a couple times but it never happens.	We have tried to break-up a couple of times, but it does not happen.
Oh and some because theyre thin and skinny and nowadays anorexic girls are a turn on.	Also some who are thin and skinny because these days anorexic girls are attractive.
if u have penis than its no problem u just hv to  penitrate her pussy with ur errect penis.	You would use your erect penis to penetrate her vagina.
in that case tkake some defense classes.	In that case, you should take some defense classes.
I just got out of a 3 yr relationship with my baby's father.	I just ended a three-year relationship with the father of my baby.
what happened when the politician took viagra?	What happened when the politician ingested viagra?
Hi, my name is xxxxxx  Been working for me for years.	Hello, my name is xxxx has been working for me for years.
i can onli say...women r complicated...	I can only state that women are complicated.
We like soft approch and a lil bit of chasing.	We enjoy a gentle approach and a tiny bit of chasing.
you would be genuinly suprised in the type of people that go to them.	You would actually be surprised at the kind of people that go to them.
it is very fun and enjoyable especially when you meet each other after texting a few months	It is invigorating, especially when you meet each other again after texting for several months.
Hey, I'm in NYC I'll help you out if your around!	I am in New York currently, I'd love to show you around if you'd like.
Sounds strange but it worked in about 3-5 days for me!	It sounds strange, but it worked in 3-5 days.
Don't worry, I aint working with much either.	Don't worry, I don't have that many option myself.
why does it matter what they think if they dont get along dont spend time togather.	Why does it matter what the think, if they don't even take the effort to get along or spend time together?
if he is then you have a good man.	You have a good man, if he is.
If He Likes You, You'll Know!	You will know if he is attracted to you!
i guess its normal, but id just move on	I suppose it is normal, but I would just move on.
The rest is easy from there!!	From there, the rest is easy!
I like any guy that is funny.	I am attracted to any man that is funny.
Girl only you can decide on this...	Only you can decide on this, woman.
Why do you ask this question??????????????	Why do you ask this question?
do go telling everyone just because you think thats right.	Do not go telling everyone, just because you think that is the right thing to do.
10 years gap is just nice.	A ten-year gap is just nice.
Then if he still doesn't like you, then move on.	Then move on if he still does not like you.
ok i see him ever week in psr but i just cant talk to him!!!	I see him every week but I just cannot talk to him.
Beacuse they feel insecure with less educated guys..........	That is because they feel insecure with less educated men.
For one thing if it doesn't work out there goes your job.	For one thing, there goes your job if it does not work out.
And I hope to God it doesn't ever pass!	And I just pray that it never passes!
Only the ones that aren't worth your time	It is only the ones that are not worth your time.
smaller of course, and it is all about LOOKS!!	Smaller, of course, and it is all about looks!
You guys don't have any reason to hate each other.	You guys do not have any reason to hate each other.
If you don't you'll always wonder.	If you do not, you will always wonder.
Some people choose not to because of thier religion, others don't.	Some people choose not to due to their religion, others do not.
give it a chance because if you break up with them it would be harder to be friends	Give it a chance, if you break up with them it will be harder to remain friends.
The Best of Luck to ya!	Best of luck!
Men who were not ready to committ.	Men who were not ready to commit.
this is a big day in both of your lives, it shouldnt be done quickly and without thought.	This is a big day in both of your lives and it should not be done quickly and without thought.
i'm 55 years old and still live at home with my mammy,whats wrong with that!!!!	I am fifty-five years old and still live at home with my mother, what is wrong with that?
one man willing to move 21 hours/1,400 miles just to be with me.	One man willing to move twenty-one hours and fourteen hundred miles just to be with me.
I must not be ugly enough then	I must not be unattractive enough.
but thats ok. im a GIVER.WINK, WINK.	That is alright, I am a giver.
well depend on women wot she want	It depends on what the woman wants.
REMEMBER IT TAKES TWO NOT ONE	Remember that it takes two, not one.
if he really didn't like her and did like you, then he would have already dumped her for you.	If he did not like her and likes you, then he would have already broken up with her for you.
hang around untill the bar closes -- or visit a prison	Remain until the tavern closes, or visit a prison.
PLEASE DONT MISS OUT ON THIS ONE !!	Please do not miss out on this one.
Because believe it or not, women hate cocky men.	Because, believe it or not, women hate cocky men.
But stick with wats inside of u.	Stick with what's inside of you.
Hell, it happened to me twice.	It happened to me twice.
Maybe your young, I don't know.	Maybe you're young, I don't know.
No matter what he says, Action speaks louder then words	No matter what he says, actions speak louder than words.
aint nothing in the world like a big boned gurl!	I like a big boned girl.
( even if he  is rich, dont sell ur self.	Do not sell yourself, even if he is rich.
just moved to Sacramento, Gay male, 30	I just moved to Sacramento. I am a homosexual male, age 30.
the people who are around you now, like your friends, should like you no matter what!	The people around you, including friends, should like you for who you are.
cuz they like the little titis and pussys	They like tiny women.
Wait til you get older and if you both STILL feel the same way then go for it!	Wait until you are older, and if you have the same feelings then you should go for it!
yes im not one of those people but i know there are lots of them	I am not that type of person, however I know plenty of people like that.
No, not if you have to ask...	If you have to ask, then that is a negative.
and you want to suck another man's D**K???	You want to be together with someone else?
coz they are girls man and they are not as sofisticated as we are !	They are woman enough for a man, but they aren't as sophisticated as us.
'...does this mean he likes me?.	Does this mean that he likes me?
Dont worry about him n just sonsentrate in school so you can lern n then woory bout yer b/f	Do not worry about him. Concentrate in school so that you can learn, then worry about your boyfriend later.
I dated one and I know.	I dated someone like that, so I know.
look at the way she walks.	Observe the way that she walks.
No (at least I hope not).	No, or any event I hope it is not so.
hello: i am looking to visit your country.	I would like to visit your country.
Overtime should I give him another chance?	Should I provide him with another chance at some point in time?
The same guy you wanna be in a relationship with?	Do you want to be in a relationship with the same man?
i went and there he was.	I went and there he was.
(that's what i called it).. but , why?	That is what I called it, but why?
that way you can still go by your last name!	That way you can still go by your last name!
both of u work hard to get it right!!	Both of you work hard to get it right!
i have told her i liked her and she said she would want to ruin or friendship.	I have told her that I liked her and she said she would not want to ruin the friendship.
you can join a community site with live chat and webcam chat	You can join a community site with live chat and webcam chat.
show her your naked baby pictures.	Show her your naked baby pictures.
Is very important to last at least 30-45 minutes!!!	It is very important to last at least thirty to forty-five minutes!
but I am not telling you to be celibate till then ;-)	But I am not telling you that you have to be celibate until then.
If he if flurting with her ok jump him .	If he is flirting with her, then okay, jump him.
I love curly hair I like to run my fingers thru it	I enjoy curly hair. I like running my fingers through it.
I want my wife to GROW too.	I want my wife to grow as well.
Well that is just the way it is I guess.	I suppose that is merely the way it is.
One girl Michelle, who probably wouldn't mind being named, spoke up and said she didn't believe in it.	One woman, Michelle, who most likely would not mind being named, said she did not believe in it.
I can just toss him to side and forget about him like last night's trash........LOL	I can simply stop caring about him and forget about him as though he meant nothing to me.
but he was a lil busy after that.	But he was rather busy after that.
I do not know what to do because she knows how much I care about him.	I do not know what to do because she knows how much I care about him.
If you do eat something like that then just quit.	If you do eat something like that, then quit.
it could be that u need to piss or the last dream u had	It could be that you need to urinate or a by-product of your last dream.
You know.......if he wants to wear my pants all he has to do is ask.......sheesh!	If he wants to wear my pants, he only has to ask.
If you were friends before and have stronger feelings now then it should be O>K>	If you were friends before and now have stronger feelings, then it should be alright.
and i want to try again.	Also, I would like to try again.
figure out what style of arrangements you would like and flowers.	Decide which style of arrangements and flowers that you would like.
Lie lie lie and then Lie some more	Lie, lie, lie and then lie some more.
Wait until you find that out for sure first and then go from there!	Wait until you find that out for certain and then move on from there.
If you two are at a dance, he shouldn't really care.	He should not care if you are at a dance together.
Trust him,  don't bring it up again.	Trust him and do not bring it up again.
honestly, most girls are just Waiting for the guy to Tell her how he truly feels.	Most women are waiting for a man to tell her his true feelings.
HELL YA I WOULD LOVE TO MEET THE LADYS!!	I would like to meet women.
I actually ponder this one now and again.	I frequently think about this issue.
i met this guy once, very romantic, i met him in this huge rainstorm.	I met a man one time in a huge rainstorm.  It was very romantic.
ok now some guy's like girls like that and some don't	Some men like women like that and some do not.
it comes right after threeplay and before fiveplay.	It comes between three-play and five-play.
When I fall in love, I feel stupid.	I feel senseless when I fall in love.
If you have to ask, then you are not in love.	You are not in love if you have to ask.
If you start to feel the it comming on then start the four play again.	If you begin to feel it happening, then start the foreplay again.
i don't understand someone please give me the answer	I do not understand. Someone please give me the answer.
i saved a good $500-600 doing my own flowers and it was no hassle at all.	I saved $500-600 by doing my own flowers and it was simple.
I JUST GOT A  DIVORCE AND SO DO DID HE.	I recently got divorced and so did he.
But ask a girl about the sympthoms because i'm a boy.	But ask a woman about the symptoms, because I am a man.
Be you show a little toghness thats what girls like atleast most of them but mostly be yourself	Be genuine for the most part, but show some toughness, as that is what most women appreciate.
follow ur heart... it's neva wrong	Obey your feelings, they are never wrong.
They bother U all day long.	They bother you all day.
See if he calls, e-mails or even cares.	See if he calls, sends an e-mail, or even cares.
you can do a civilian arrest  answ3r3r	You can do a civilian arrest answer.
a spasm in your back usually	Usually, it is a spasm in your back.
by now, you might love your wife for everything you guys have endured.	By now, you might love your wife after everything you have endured together.
GOOD LUCK AND I HOPE EVERYTHING GOES WELL!	Good luck, and I hope everything goes well!
say i love you and if the wait to say it back it tells it all	"Tell them ""I love you."" It will tell you everything, if they wait to say it back."
Try asking her out again and see what she says.	Attempt to ask her out again and notice her response.
;)  There is no way to make someone fall in love with you.	There is no way to make someone fall in love with you.
Ask her questions (don't just talk).	Ask her questions and do not monopolize the conversation.
When you first fall in love, your gitty, goofy, and silly happy just thinking about that person.	When you first fall in love, you become giddy simply thinking about that person.
And remember there is more then 1!	Remember, there is more than one.
i think they just look better than a whole lot of nations out there.	I think they look better than many of the nations that exist.
We got married all over again!	We got married all over again.
All in all I don't think it really matters.	All in all, I do not think it matters.
And Im sure as heck not driving 5 hrs just to hang out unless I really really like her.	I am sure not driving five hours to hang out unless I truly like her.
how often can you have sex with pam anderson?	How often can you have intercourse with Pam Anderson?
I told her that I loved her and truly meant it.	I told her that I loved her and I truly meant it.
think about what good it brought about.	Consider what good it brought about.
the thing is im a person that does not like to brake others heart.	The think is, I am a person that does not like to break people's hearts.
give a rose and express ur love	Giver her a rose and express your love.
I LIKE THICK BECAUSE I FEEL CHEATED WITH A THIN ONE!	I prefer a think one over a thin one.
Remember, TILL DEATH DO YOU PART!!	Remember, untill death do you part.
Bcozz we always find a life partner therfor we attract with opposite side	We will always find a life partner, that is why we usually attract someone with an opposite personality.
what the hell r ya talking abt?	What are you talking about?
IF YOU KEEP TALKING TO HIM FOR ANOTHER WEEK,HE MIGHT THINK HE IS MARRIED TO YOU.	If you have to keep talking to him for another week, he may think that you two are married.
women dont want much, just some acknowldgement and sometimes help.	Women don't need that much, just to be acknowledged and helped occasionally.
At least thats what it seems like to me.	It seemed like that to me anyway.
Don't be afraid to say no.	Do not be afraid to say no.
dump him...there are always more fish in the sea.	Let him go as there are always more fish in the sea.
TO ME IT REALY DOSE'NT  MATTER, BUT A HAND FULL IS QUITE ENOUGHT FOR ME.	It really does not matter, but I am fine with a handful.
choose the one that adores you the most!	Pick the one who loves you the most.
you still released at least a thousand!	You released a thousand.
You go to a bar and get drunk!	You can go to a bar and get intoxicated.
give it some time and thought.	Just give it some time and thought.
no u shouldnt leave them...just teach them what to do to please u better...	You should not leave them. Teach them what to do to please you better.
bembie hit the nail on the head	You are speaking the truth.
no.u guys kiss when ur ready	Kiss when you are ready.
haha julesac is funny, but mean.	Julesac is funny and mean.
If youre asking this, u surely have already distanced yourself from her and yet remaining a friend.	It seems that you have distanced yourself from her but are still friends.
DONT FORGET TO CHOOSE AND VOTE FOR BEST ANSWER!!!	Do not forget to choose, and vote for the best answer!
Dont try to figure it out thats jus the way it is.	Do no try to figure it out, that is just the way it is.
I dont know.But i know of another website that i go to..	I do not know. But I know of another website I visit.
OK IT DEPENDS ON HOW MUCH YOUR STARTING TO HAVE FEELINGS FOR THIS BOY!	Alright, it depends how much feeling you have for this man.
!he must be a control freak	He must be controlling.
IT ALL DEPENDS ON THE GIRL OR THE AND HOW INTERSTED THE GIRL IS IN THE GUY.	It all depends on how interested the woman is, in the man.
look, try and get out to meet people.	Try to get out and meet people.
usually it is multiple things not just one thing	Usually it is not just one thing, it is multiple.
if u really really really really really really like them	If you really admire them.
For the guys: (A) Do you prefer a bigger woman or a smaller woman?	This question is for the men.  (A) What size woman do you prefer?
If all you do is argue it's not worth it..	It is not worth it, if all you do is argue.
What makes it worse is that I already went out with him for four years!!!!	What makes it worse, is that I dated him for four years.
u just have to be patient and the right girl will come along.	The right woman will come along if you are patient.
unless you dont love your husband anymore and you have room for another man????	If you do not love your husband any longer, than move on and make room for another man.
wife because then you can do more with out comminting a sin	You can do more sexual things with your wife and it is not a sin.
She definitely wants you to think she's good looking, but she doesn't want that to be reason #1.	She does not want you to like her solely for her good looks.
Depends, some days I want to have sex, somedays I don't.	I want sex here and there.
plus they are more passionate in love makin.	Women are more passionate during sex.
If you play w/both at the same time, she will probably f-*# the sh%$ out of you!	If you play with both at the same time, she will probably have sexual intercourse with you.
Because he wouldn't work, hit me, used guilt trips, was a big mama's boy, etc.	Because he would not work, hit me, used guilt trips, and was a big mama's boy.
maybe because your the most beautiful girl they have seen.	Maybe because you are the most beautiful girl they have seen.
it really depends if someone is vain or not.	It really depends on if someone is vain or not.
someone i can be myself with.	I want someone that I can be myself with.
Send me your picture and contact me ..	Send me your picture and contact me.
Stay away from this guy friend.	Stay away from the guy-friend.
the doctor can't even believe it.	The doctor cannot even believe it.
yes for sure, especially when she throw up!!	Yes, especially when she vomited.
If not, then don't sweat it!	Do not sweat it.
i could give you some pointers.	I could give you some advice?
If you feel your love is fading, don't just sit there and do nothing!	If your love is fading, do something about it.
I will not stay with someone I don't trust.	I will not be with someone who lost my trust.
i only once told a girl that i loved her, and i meant it.	Only once have I told a girl that I loved her, and I meant it.
You married him and it was for a reason.	You married him for a reason.
Rip off your shirt and do a Tarzan yell.	You should rip off your shirt and do a Tarzan style yell.
Yes, girl down there, don't have sex.	Do not have sex.
they accept this in thier culture.	It is acceptable in their culture.
Always trail ride with a friend.	Always go with a friend.
you didn't give us very good information/  do you all live in one house.	You did not give us good information. Do you all live in the same house?
Move on - so what if he's hot...looks aren't everything.	Looks are not everything and you should move on.
lol  most important... just be yourself.	The most important thing is to be yourself.
yes be disappointed and be mad!!	Yes, be disappointed and be angry.
Sorry, I never have felt that way!	I am sorry but I have never felt that way.
i sure wont like any girl who would make my life difficult...	I sure would not like any woman who makes my life difficult.
Or if he gets them first, you get the popcorn.	Or if he gets the tickets, then you get the popcorn.
practice, ask if your doing good.	Practice, then ask how you are doing.
but if u are sure then first tell your parents if you havent done allready.	But, if you are sure then tell your parents first if you have not done so already.
well i met mine in a carnival.	I met mine in a carnival.
Sounds like a rhetorical question :)	It sounds like a rhetorical question.
WELL I BELIEVE EVERYBODY SHOULD KEEP THEIR OWN NAME.	I believe everybody should keep their own name.
but ur first kiss should feel like ur in hevan.	But your first kiss should feel like you are in heaven.
There is nothing but trouble there!	There is only trouble there.
How to make a woman happy  To make a woman happy....?	I would like to know how to make a woman happy.  Can you give me some advice?
dont do things tht can get you hurt.	Do not do anything that can hurt you.
i mean of course you will be making more money if you work hard.	Of course you will make more money if you work hard.
Please don't go up to her and tell her how good she looks.	Please do not go up to her and tell her how attractive she is.
I don't think it's good idea, u are not there for this purpose!	I do not believe that is a good idea, you are not there for that purpose.
go up to her and say 'hi, are you single?'	"Walk up to her and say ""Hello, are you single?""."
i think he would make a great valentine.	I believe that he would make a great Valentine.
Just be prepared to let her go.	You should be prepared to let her go.
rather than just sit there and wait till u are a good one.	Instead of just sitting there and waiting until you are a good one.
Just tell them, what are they gonna do, slap you??	Just talk to them, what are they going to do, slap you?
Get a massage..and get away from it all..hehe..	Get a massage, and leave it all, haha..
Well if u really like this guy smile and make nice talk with him.	Well, if you really enjoy this boy, smile and speak politely with him.
take them both out at the same time	Take both of them out at the same time.
it happened to me and i am now dating that person	It happened to me and I am now seeing that person.
only two points to make friends  1.	There are only two ways to make acquaintances.
so you might just be over looking the type of men who think the world of you..	You might be finished searching for the class of men that think the world of you.
Preferrably someone who doesn't hate you.	Preferably, someone who doesn't dislike you.
We tried to move on but it didn't work.	We attempted to move on, but it didn't occur.
WHEN WILL PEOPLE IN THIS EFFED UP WORLD FINALLY REALIZE THIS?!?!?!?!?!?!	When will people in this damaged world finally realize this?
I wouldn't bother calling him back.	I would not take the trouble to call him back.
Try not to hang out with him and find another guy.	Attempt not to spend time with him and search for another man.
look for another hot girl, so she will be jealous.	Search for another attractive woman and she will be jealous.
so in my opinon ur not a hoe!	Therefore, in my opinion, you are not promiscuous.
Red= love, black = death ect...	Colors have associations with feelings.
if she likes him than she dont like u dump her is not his fault that she strays	If she likes him over you, you should dump her. It is not his fault she is unfaithful.
for me anything after 3 days and i might start to forget about you.	If you do not contact me after 3 days, I might start to forget about you.
find a girl who has talets she also must be prety	You will find a girl who has talents and is attractive.
There no one you can trust more than a good friend !	There is no one you can trust more then a good friend.
start the day off with breakfast out...then perhaps a nice walk.	Start the day with breakfast and a good walk.
Then go pick them up (If she say yes).	If she says yes, pick her up.
If yes, why do I heard some girl said flowers ar not going to last?	Why do I hear some girls say that flowers are not going to last?
may be its interesting for them	It might be interesting for them.
could it ever be the same...	Could it ever be the same?
it's not that bad... at least it is not Bella	It is not that bad; at least it is not Bella.
Could it be because some men are liars and fat mouths??	Could it possibly be because some men are liars and big mouths?
Or you could tell her and have one of those fairy tale romances...	Or you could just tell her and then have one of those fairy tale romances.
FINALLY A CULTURE THAT HAS IT RIGHT.	Finally, a culture that has it correct.
my twin wont talk or listen to me	My twin will not talk nor listen to me.
want to get something you can not get rid of go ahead then	Go ahead and get something that you cannot get rid of.
Only I am not thinking about him but I am having dreams about him.	I am not thinking about him, but I am having dreams with him in them.
if ur talkin ten then i think it would be fine to get a video/ computer game.	I think it would be passable for you to get a video/computer game.
Go for it and take the chance!!!	You should go for it, and take the chance.
If he CAN'T then take him to a place where they have slowdances (dinner date, maybe?)	If he cannot, then take him to a place where they have music to slow dance to, or a dinner date.
i feel this is most beautiful in a family life.	I feel as if this is the most beautiful thing about family life.
IT'S YOUR CHOICE NOT TO  HATE ONE,  I DISLIKE THEM TO SAY THE LEAST.	It is your choice not to hate one. I dislike them, to say the least.
NEVER ever get married without a Prenup....	You should never get married without a prenuptual agreement.
Get a life and don't waste mine.	You should pursue an active life and not waste my time.
She says your too good for her?	Is she saying the thinks you are too good for her?
Guys come & go, but friends are forever!	Relationships with men end, but friends are forever.
it could probably mean a lot of things.	It could mean any number of things.
yes it is normal cause their is lots of people who still likes some they broke up with.	It is normal, because there are a lot of people who still like someone that they broke up with.
I`d like to see what a black female has to say about this.	I would like to see what an African-American has to say about this.
guys are stupid!who knows why they do what they do.	Men are daft, who knows why they do what they do.
well if they gave you their phone number you dont have to wait at all	You do not have to wait at all, if they gave you their phone number.
cause were masters of the universe...	Because we were, Masters of the Universe.
I'm in love and don't care who knows it Buddy the Elf.	I am in love and I do not care who it, Buddy the Elf.
And whatever you do, don't try to have both of them at once.	Do not try to have both of the at once, no matter what.
if you really wanted to be with him, you wouldn't be asking.	If you truly wanted to be with him, you would not have to ask.
Remember being friends with someone online is ok but there are limits.	Remember, being friends with someone online is okay, however, there are limits.
when my sis kisses someone she closes her eyes to get ready.	When my sister kisses someone, she closes her eyes to get prepared.
Now me, I wouldn't marry any women who didn't want to change her name, but that is just me.	Now me, I wouldn't marry any woman who didn't want to change her name, but that is just me.
Umm small party for the family	Small party for the family.
girls are perverts they just hide it and act like it around other girls secretly	Girls are perverts, they just hide it and act like it around other girls secretly.
and im only in  fith grade o ya!	I'm only in fifth grade.
But you do what you want.	But you do what you want.
Don't do that, it won't work.	Do not do that, it will not work.
If they don't, it's time to move on.	It is time to move on if they do not.
He everything I ever wanted with the looks, money, stuff.	He has everything that I could ever want, handsome, financially secure, etc.
Yes, and it is bad luck to see the bride at the wedding.	It is bad luck to see the bride before the wedding.
Nope, she is not a liar.	No, she isn't lying.
SHUT THE HELL UP AND BE GAY IF YOU WANT TO!!!	Be quiet, and live the truest version of yourself.
and he had his nose pierced.	He has his nose pierced.
yup, i can lift him, he's only 185....lol	I can't lift him, and he is only 185 pounds.
you need a therapist for that.	You should have a therapist for that.
Maybe some perverted guys like the really young looking asian girls	Perhaps some vulgar young men enjoy the younger asian ladies.
You should go see a shrink!	You should make an appointment with a therapist!
Giving you stupid excuses of the wall!Acting the way he didn't before!	Giving you ridiculous excuses, off of the wall! Acting differently than he did before!
Be strong, and hang in there.	Be tough and hang in there.
Nope, he's too darned big and I'm too darned weak!	Absolutely not, he is too hefty and I am undesirably frail.
Basically if she is so drunk that she becomes a slob / or slut then yes it is unattractive...	Basically, it is very unattractive if she is so inebriated that she becomes a promiscuous ragamuffin.
Exchange letters, e-mails, chat online, talk over the phone, send packages...  Just keep in touch!	Keep in touch by exchanging letters and emails, enjoy online chats and phone calls, and even sending each other packages.
Especially if you don't feel like it.	You do not have to especially if you do not feel like it.
he dribbles... he shoots... he scores... 2 points...	He dribbles, shoots, and scores two points.
Giving it up just for him to stick around is like selling your soul to the devil.	Giving it up just for him to stay with you is like selling your soul to the devil.
I cant give you a wife view but hopefully mine is just as good.	I cannot give you a wife view, but hopefully mine is just as good.
plus it takes the pressure off of me to ask someone...	It also takes the pressure off of me to ask someone.
Depends on the woman, it's better shaved=-)	It depends on the woman, but it is better shaved.
ask in english terms...cannot understand you	Please ask the question in English; I am unable to understand you.
hey, I'm a guy, but i'll tell you a little.	Hello, I am a male, but I will tell you a little bit.
i like him alot and i want to win him over not push him away.	I do like him a lot and I want to win him over, not push him away.
Ok Like I really really really like this guy and I dont know if he likes me back.	I like this man; however, I am uncertain whether he also likes me.
btw - ur avatar looks familiar.	Your avatar looks familiar to me.
It's been over 6 months & I can't seem to get over it.	I just cannot seem to move on even after six months.
maybe he thinks he will  be turned down.just ask...i would.	Perhaps he is concerned about rejection, and you should act as I would, which is to ask.
You gotta think about that and that should help you out on seeing if you can trust him!	You must think about that, which should help you decide whether you can trust him.
A picture the shape of a heart with you and her when you both first dated....thats special	A picture of the shape of a heart with you and her when you both first dated, that is special.
i am in college and he is my only sourse of income until i get out.	I am in college and he is my only source of income until I graduate.
listen it aint that easy.I got with my ex-boyfriend in 2nd grade,then again in 4th,and again in 8th.	Listen, it is not easy because I got with my ex-boyfriend in 2nd grade, 4th grade, and 8th grade.
i've been with this girl for 8 months and we haven't kissed is this bad?	I have been with this girl for 8 months and we have not kissed, is that bad?
Some guys don't like boobs at all!	Some guys do not like breasts at all.
or that she just wants to see other people?	Or that she just desires to go out with other people?
And hes seen me every day for about 4 or 5 years!	And he has seen me every day for approximately four or five years!
there was his stop so he got off the train.	There was his stop so he left the train.
I mean the worst -the absolute worst - is that she says no.TAKE A CHANCE & GOOD LUCK!	You should take a chance because the worst outcome is that she says no.
But, I know exactly what I want in a relationship.	I know, however, what I want in a relationship.
i would flirt and send flowers and candies to my self and then he would ask u out sometime	Consider flirting and sending flowers and candies to yourself, and he may then ask you out.
I also hate seeing my dad unhappy.	Also, i dislike it when my father is unhappy.
I feel bad because I know that I snore sometime -- most people do, right?	I feel bad because I know that I do snore sometimes. Don't most people?
i like sos and need to know if im in love	I like Scott and need to know if I am in love.
If you guys TRUELY love each other then u can work out all the fighting etc.	If the two of you truly love each other, then you can work out all of your disagreements.
because neither of you have the guts to call it quits	Because neither one of you have the guts to call it quits yet.
However that does not mean that big girls can't be cute.	However, that certainly does not mean that big girls can't be cute.
But he is getting married this month.	He is getting married this month.
But those guys are jerks and you don't want them anwyay.	Those men are dolts and you do not want them anyway.
SAY WILL U GO OUT WITH ME!!!!!!!!	"Just ask, ""Will you go out with me?"""
and get married only after you've been with a guy for more than 2 years.	Get married only after you have been with a man for more than two years.
Man has penis and woman has clitoris.	A man has a penis, and a woman has a clitoris.
SEPERATE THE BAD THING AND MOVE ON!	You need to seperate the bad thing and move on.
(It would be easier to do if I were mad, though!!	If I were mad, it would be easier to do.
If she will tell the administration i will be expelled coz its pakistan not america	If she tells the admininstration, I will be expelled because it is Pakistan, and not America.
you should get to know her and sooner or later you will ask her out or she will.	You should get to know her, and one of you will ask the other out.
Like I said; he already knows that you like him, so just take a deep breathe and ask him.	Like I said, he already knows that you like him, so just take a deep breath, and ask him.
Maybe you and I can get together sometime & we'll find love with one another.	Maybe you and I can gt together sometime.  Perhaps even find love in one another.
I would be, but I'm just married !	I would be, but I am married.
Play the field a bit now.	Play the field a little bit.
As everyone said... dont get married so early.	As everyone said, don't get married so early.
just want to know HAVE YOU BEEN TO THE DOC YET !	I just want to know, have you been to the doctor yet?
Pay Attention to what the other person says!	Pay attention to what the other person says.
Just Talk your spouse about this	Simply communicate with your spouse about this.
if you are into sixth graders you are obviously young.	If you are interested in sixth graders, you are obviously young.
i was thinking about a medium pink color, but with what??	I was considering a medium pink color, but paired with what?
Ask if they wanna go somewhere with you.	Ask them if they would like to go somewhere with you.
-a trip to amusement park such as roller coaster or even theatrical museum.	I would like a trip to an amusement park, or a museum.
Or do guys really do prefer bigger women?	Do goys prefer bigger women?
problem is i really like him.	I like him.
so id say, they do work out, just not a lot of the times...hope this helps...	It can work out, just not all the time.
SHould I dump him because of his mother	Should I break up with him because of his mother?
I did this before (accidentally) and my friend was mad that I deleted him!	I accidentally did this before and my friend was mad that I deleted him!
I dont think I mind either way.	I do not think I mind either way.
but thats her way... you could try it that way or you could just keep your eyes open...	But that is her way. You could try it that way or you could just keep your eyes open.
there are some that do, but you should be able to tel.	There are some that do but you should be able to tell.
r u talking about ur avatar?	Are you referring to your avatar?
I dont ever remember giving a girl a Cristmas gift unless I liked her.	I do not recall ever giving a girl a Christmas gift unless I cared for her.
I don't know what to do.	I do not know what to do.
Try to be your self and don't show off	Attempt to be authentic and do not act ostentatiously.
so just take it day by day-step by step.think of how he lost a good thing.	Simply proceed one step at a time. Consider how he lost a something positive.
Dang it, if only every man knew What Women Want the world would be a much happier place!!!	"If only every man would watch ""What Women Want"" the would be a much happier place!"
compliments, honesty and make it about her.	Compliments, honesty, and focus on her.
i think hse will crash him!	I think he will crush him!
IT JUST MEANS THAT SHE IS REALLY INTERESTED IN THE GUY.	It means she is interested in him.
please do.. im thinking  you would get slapped mid-reach,or kicked in the groin.	Please try. I think you will be slapped mid-reach, or kicked in the groin.
Only now she and I are both divorced.	She and I are both divorced.
if he/she want to see you picture rightaway it sex!	Does she want to see a picture of you right away?
hey it's better than her givin u a fake # to call lol!	It is better then giving her a fake number.
tell her to move to MASS.............	She need to move to Massachusetts.
if you feel this strongly about it then maybe you shouldn't get married.	If you feel so strongly about it, perhaps you should not get married.
The pictures I've seen...I would say Maui or the Bahamas.	From the photographs I have seen, I would say Maui or the Bahamas.
the guy i like is mad at me.	The man I like is angry with me.
You're 13 don't even worry about it...	You are 13, do not concern yourself with it.
That way you dont have to worry about you calling him too much!	Do not worry about calling him too much.
I am a guy and let me tell you, we love to chase!	I am a guy and we like to chase women.
Thanks for the pep in advance!	Thank you in advance.
we always seem to push the ones taht we love away.	We always seems to push away the ones that we love.
they think that they can control other peoples lives when thye cant	They think that they can control other people's lives.
thats weird but maybe idk ill talk to my friend by his locker.	That is odd, but perhaps, I will talk to my friend by his locker.
I don't know....how would you like something crammed up your butt!!	I am not sure, how would you like to have an article forced into your derriere.
If a guy cares he calls.	If a man cares about you, then he will call.
what special gift can i give my would be brother in law for his birthday?	What is a special gift that I may give my future brother in law on his birthday?
he probably doesnt want to either.	It is probable he does not want to either.
hold her hands, look to her eyes and say it, but only say it if you really love her.	Hold on to her hands, gaze in her eyes and say it, however, only say this is you really love her.
Some guys do...and some guys don't.	Some men do, others do not.
hey i really want to know so please help me out!!	I would really like to know, if you could please help me.
The timing just wasnt right for it with the old guy...you'll see!	The timing with the older man was not right, you will see.
Generally kind and my fifth: I'll just be dissapointed if she's stupid.	Generally kind and I will be disappointed if she is stupid.
its one of the gifts we can always give ourselves.	It is one of the gifts that we are always able to give ourselves.
I do not believe trust has to be earned, because how is that even possible.	I do not believe trust has to be earned, because how is that even possible?
lol so if thats u u deff need to stop that is FONKY!!	So, if that is you, you sincerely need to stop as that is most unorthodox.
DON'T LET HER RULE YOUR LIFE, SHE WILL JUST HAVE TO LEARN TO DEAL WITH IT.	Do not allow her to dominate your life for she will simply have to learn to deal with it.
I have yahoo email and that works for me.	I have Yahoo email, and that works for me.
I wouldn't worry too much about it.	I would suggest not worrying about it overmuch.
Oh yes, the trick ass hoe's never had a chance.	Yes, the promiscuous women never had a chance.
when you can fart in front of the one your dating	When you can pass gas in front of the one with whom you are in a relationship.
depends on how old they are.	It depends on their age.
And any guy who sas he woul is prolly not being entirely honest with himself.	Any man that says that he would, is probably not being entirely honest with himself.
If you flirt with him, the challange is not there.	If you philander him, then the challnge is not there.
If you need your x emotionally - then ya got some troubles.	If you need you ex emotionally, then you are going to have some troubles.
20 to 32...she doesn't have to be younger than you.	She does not have to be younger than you, 20-32 will do.
my be she don't love  you but  try to use your  brean not  your haerd	Try to use your brain and not your manhood, maybe she does not love you.
If you want your girlfriend forever..........then just don't let her know that you want her forever, simple.	Do not let your girlfriend know that you want her forever.
There are tons of cheap ideas out there, just find what you like and work with it!	There are plenty of cheap ides out there; you just need to find what you like and work at it.
And if you are worried about doing it - performance wise - DONT.	If you are skeptical about the performance piece of it, then do not do it.
find a nother girl and if that dosent work move back	Try another woman and if it fails, then move back.
Most often (not always) that will be guys around your age, give ot take.	Most often that will be guys around your age.
if u you act like dat all da time she might think u desperate.	If you act like that all the time she might think you are desperate.
not everyone on here is in school.	Not everyone on here is in school.
tell him what you really want...that's what they tell me but never got to do...speak up...	Tell him what you really want; that is what they tell me even though they never got to do that, so speak up.
should i  make the first move or should i wait for him to make the first move ?	Should I make the first move or should I wait for him to make the first move?
What a typical double standard you have set up!!	What a typical double standard you have.
after a while you dont even see the color.	After a while you don't even see the color.
:) I haven't tried it yet, but I am still trying to get up the nerve....	I haven't tried it yet but I am still trying to get up the nerve.
If you two are serious then asking her that question shouldn't bother her.	If you two are serious, asking her that question shouldn't bother her.
sak her out what's up with that?	Ask her out, what's up with that?
How about...Would you like to go out with me sometime?	Would you like to go out with me sometime?
yah look me up if you are ever in florida  lol!!!	Yes, look me up if you are ever in Florida.
Those was good times I tells ya.	I tell you, those were good times.
its all about her, and no it shouldnt be something that happends on a first date.	It is all about her. No, it should not be something that happens on a first date.
Do you really want to spend the rest of your life with someone you argue with all the time.	Do you honestly want to spend the rest of your life with someone you argue with all the time?
If he comes to his senses then great if not SCREW HIM!!	If he comes to his senses, then great, if not, break up with him.
you are too good for them	You are too good for them.
Jump him because she likes him??	Have sex with him because she likes him?
depending on the age, cds or dvds.	It depends on the age, but CDs or DVDs.
20 YEARS DOWN THE ROAD THAT IS ALL YOU CAN BE SO START FROM THE BEGINNING	Twenty years down the road, that is all you can be. So, start from the beginning.
ill like to visit usa what are the needfull things	I would like to visit the United States of America.  What things would I need.
anyone with any ideas, tips or general info, email me back!!!	Anyone who has any ideas, tips, or general information, please email me back.
u sound like a very lovely person so dont let some of these gals drag you down.	You sound like a very lovely person, do not let these women drag you down.
you dont look, just go out and enjoy yourself and have fun and a gf will come along.	You do not look, just go out, enjoys yourself, have fun, and a special woman will come along.
Don't persue it, he is getting married.	Do not pursue it, he is getting married.
like clear liquid and turns yellow when dry?	Clear liquid turns yellow when it has dried.
i mean if in your country there is an short messaging system in your cellphone then find a textmate!!	If there is a short messaging system in your country, then find someone great at texting.
Then when she starts closing her eyes , kiss her in the lipps and then its up to you!	When she starts to close her eyes, kiss her on the lips.  The rest is up to you!
please be honest with me i can handle the truth	Please be honest with me.  I can handle the truth.
Have fun, and remember to never get so comfortable that you always know what's going to happen next!	Have fun, but remember not to get so comfortable that what happens next is predictable.
Its Shows how much they care about you!	It shows you how much they care about you.
Tell her that you miss her and that you love her.	Tell her that you love her and miss her.
Coffee, lunch, site seeing, walk/talk/play in the park, museum, movie matinee	Some enjoyable things to do include having coffee, lunch, site seeing, playing in the park, going to a movie matinee or museum or just walking, talking and playing.
WHAT YOU  WHANT IS A HOOKER, YOU CAN FIND THAT IN ANY CORNER OF THE WORLD.	What you want is a prostitute and you can find that in any corner of the world.
but now we do all these things together and i dont know what to do..	Now we do so many things together and I do not know what to do.
Because if it fails you be up $h*T!	If it fails, then you will be up a creek without a paddle.
and its been the best thing for at least me.	At least for me, it has been the best thing.
Try using some of these, but only if they actually apply!!!	If they apply, then try using some of these.
THE PROBLEM IS THAT HE CHEATED ON ME RECENTLY AND IT WAS THE WORST THAT HE COULD OF DONE.	The worse thing he could have done, and did, was recently cheat on me.
if you are happy she should be happy, unless he really is being bad to you.	If you are happy, then she should be happy.  Unless, he really is being bad to you.
We like it when guys do things for us and think about us.	We like it when men think about us, and perform tasks for us.
maybe if you give him space he will eventually call you back.	Maybe he will call you back eventually, if you give him space.
Tell him you don't want a real relationship.	Tell him that you do not want a real relationship.
if you look creepy and you look..they'll all think you're leering.	If you look creepy when you stare, the will think that you are leering.
I don't know about love,but he likes you for sure	I do not know about love but he certainly cares for you.
if a guy really respects u then he'll understand.	If a man truly respects you then he will understand.
ask yourself and decide.and if you can afford it, do if you want to.	Consult yourself and come to a decision. If you can afford it then do it if you are inclined.
because he is a superhero that is the closest to being just a regular guy.	Because he is the superhero that most resembles an average man.
sometimes the difficulties are worth it if the the good outweighs the bad	Sometimes the difficulties are worth it if there are more positives than negatives.
I dont think it is wise to date at work.	It is not wise to date work colleagues.
STUPID U NEED A THEORY CLASS 4 THAT!!!!!!!	You should take a theory class.
let it take it's course from there.	Let it take its course.
about what they think about gay marrige/ relationshiops?	You are asking what their stance is about gay relationships?
so ofcourse i had to ask him if he was blowin me off.	I asked him if he was blowing me off.
guys will think youre hot no matter what with this usually.	Guys will think you are attractive no matter what.
but i dont htink that by not having sex with him he will become unfaithful or leave you.	I do not think that not having sex with him will make him unfaithful toward you.
The safest rules of internet dating are these: 1. chat via email and messenger 2. chat on the phone.	The safest rules of internet dating is to chat via email and the phone.
marriage is really about trusting & communicating	Marriage is really about trust and communication.
Ok, so I had this problem too.	Ok, I have had this problem too.
depending on what you kissed ;)	What did you kiss?
it depends on if you could trust him before!	Could you trust him before?
make sure you dont make her hate you just get your point across too her	Do not make her hate you just to get your point across.
Uh- wher've U been meeting these Filipinas?	Where have you been meeting these Filipinas?
Imgaine if it was JUST considered love??	Was it concidered love?
That way, you aren't exactly telling them what you specifically don't like about them.	That way, you are not telling them what you specifically do not like about them.
If he is, then go for it!	If he is, then go ahead.
Then see if shes open for a dinner & a movie.	Then, see if she is open for dinner and a movie.
hey im sorry i don't know and i wish best of luck to both of you!	Hello, I apologize, I do not know.  I wish the best of luck to the both of you.
HOWEVER----i find him looking at me every now and then.	However, every now and then, I find him looking at me.
this is sin, our selves have started this	This is sin, we started this.
Fun includes eating meals (not breakfast if yo know what I mean).	Fun includes eating meals, and I do not mean breakfast.
MAKE A KIND MOVE , IF NO RESPONCE U KNOW WHAT TO DO !	Make a nice gesture, if there is no response, you will know what to do!
let him make the first move if u do it may make u look like ur ubsesd with him!	Let him approach you first. If you approach it will make you look obsessive of him.
You people have no right to get married!	I prefer you not marry.
My tragic love story was I loved him very much and he loved me too.	I lived him very much, and he loved me too. That is my love story.
u seem desperate and you'll never find a      if you're desperate.	You apprear desperate and you wil never find someone if you are desperate.
But he swears that we're just friends.	He says we are just friends.
looks don't really matter unless you are trying to prove something.	Looks do not matter unless you are trying to prove something.
again, i know once u have sex with him, he is no longer a good friend.	I know that once you have sex with him, he is no longer a good friend.
the fact that a guy is sooo self centered is a huge turn off for me.	The fact that a guy is self centered is a huge red flag to me.
DON'T RUSH IT FEEL ALL YOUR EMOTIONS COME ALIVE.	Do not rush it and feel all your emotions come alive.
it a two way traffic until you get them you will know which one it is	It is a two-way street until you get in a relationship with them, and then you know which way it will be.
So you have ONE baby out of wedlock.	You have one child.  Are you married?
I know i'm overtly picky about people HOW CAN I STOP IT!	How can I stop being overtly fastidious about people?
it hurts....alot...maybe some girls might say that's it?	Perhaps some women would say that it hurts a lot.
im going to jump that boy is that the right choice	That man is the right choice.  I am going to ask him to go out with me.
SO it was a good ideea!	So it was a excellent idea.
if she gets drunk then it is not a turn off.	If she gets intoxicated then it is not a turn off.
Because some women send men tiny messages with out saying it clearly.	Because some women send men tiny messages without saying it clearly.
I'd perfer if they left me alone...  sorry, i got off-topic.	I would prefer if they left me alone, and I apologize that I got off-topic.
ask her to go do something she is interested in or to see a movie she'd like.	Ask her to go do something that she is interested in, or see a movie that she would like.
You are a man <--- Term used lightly!!	You are a man, and I use that term lightly.
Haha...  Too bad it's not automatic like MSN or AOL.	Ha, ha. Too bad it is not automatic, like MSN or AOL.
and thats how they'll react to it so yea its bad situation for you and him.	That is how they will respond, so yes. This is a bad situation for you and for him.
go back to that person at once before it becomes too late for you.	Go back to that person at once before it is too late!
lol I too want to smack that smile off her face	I, too, want to smack the smile off of her face!
and ask if he wants to dance with you.	Ask him is he wants to dance with you.
then she might say that looks ugly i think (a color) looks better.	She may think that looks unattractive.  In my opinion, blue looks better.
ask him to go see a doc.	Ask him if you should go see a doctor.
I never went out with him a second time.	I did not go out with him for a second date.
First of all, why did u guys break up?	Firstly, why was the relationship not terminated?
why wait,,,,, go ahead do it	Delay for what reason? Proceed to accomplish your intent.
as long as he dosent mind , who elses opinion matters?	In the event he has no objection, what other person has a relevant viewpoint?
i think im still totally in love w/ him...	I believe I persist in feeling all-consuming romantic love for him.
I never wanted to have sex again.	I wished to never again have sexual activity.
The main thing is to not try to get back at the one who wronged you.	It is critical that you do not seek revenge agains the one who wronged youl
if u have to ask other people i really dont think ur ready to	I do not think you are ready if you have to ask other people.
Im a gilr, i say those things....	I say those things and I am female.
a big savings area is flowers.	You can save money with respect to flowers.
time wiil tell give it six months and see what happens.	You will know in time, and I recommend seeing what happens for six months.
either that or you are the only one he has a chance at getting some booty from	Either that, or you are the only one he has a chance of having sex with.
well from your list, i would have to choose spiderman.	"Well, from your list, I would have to choose ""Spiderman""."
i was cheated on for 3 of the years.	I was cheated on for three of those years.
all seniors think freshman girls are easy, its sad but true	All seniors believe freshman girls are loose. It is sad, but true.
and if he says yes than you can tell him.	If he says yes, then you can tell him.
and impress her with affection and love.	Impress her with affection and love.
And if you have, what was it like?	If you have, what was it like?
Celebrate Valentine with joy and fun...give eachother gifts and hav a fun...	Celebrate Valentine's Day with happiness, gift-giving, and fun.
any women beside the ugly guys will look hot...	Any woman looks attractive when standing beside an unattractive man.
So, when I moved in my neighbor asked me out.	When I move in i was asked out by my neighbor.
you should probaly make a move because he is obviosly shy	You probably should act because he appears to be shy.
just on a much harsher scale as time goes on.	It becomes more difficult as time passes.
be yourself say whats up and you might get a response	If you act yourself and ask about what is happening, you might get a response.
there are many times that you love the guy but not sure did he love you also.	There are several times that you love the man, but are not sure he also loved you.
if your talkin hubby or the like i'd say tools toys for his vehicle, sports related things.	If you are talking husband or the like, I would say tools, toys for his automobile and items related to sports.
That got me really hot, but I ran off.	That made me really angry, but I left.
Me, I'll pick up the tab if, I can get your vote for best answer.	Me, I'll pick up the bill, if I can have your vote for the best answer.
k. So what size of breast does the average guy like do you think?	Okay. So what size of the breast does the general man enjoy, do you believe?
many women 22 are dating men 27 so the 22 yo men feel insecure and have to fish downstream	A lot of women date older men, so men feel insecure and date younger women.
Lust less like...you just go out?	Did you go on a date?
they probobly know you cant really hide that but you should tell your parents	You should tell your parents. You can not hide.
I will make u princess in planet Kripton !!	I want you to be mine.
My last girlfriend's Bf did that to her (before we met), and she still kept him.	I know someone who had that happen, and she still dated the guy.
my friend has a bf who she talks 2 online and on the phone.	My friend has a boyfriend who she talks to online and over the phone.
do you like fake nails or manicured ones?	Do you like false nails or manicured nails?
Tell her, girls like to her the truth GOOD LUCK	Tell her. Women like to hear the truth. Good luck.
we can restle around and be the best of friends.	We can wrestle together and be best friends.
Stay true to your husband...after all, he's the one you said I do to...	Remain faithful to your husband. After all, you married him.
DONT LISTEN TO THESE FOOLS WITH AL THEIR B.S.	Don't listen to any of these other people's answers.
yeah, im a guy so i dont really have to pay.	I am a man, so I don't have to pay.
Remember, NO BIRD EVER FLEW ON ONE WING!!	Remember, no bird has ever tried to fly with one wing.
just let her know what you feel.	Just be honest about your feelings towards her.
it depends, if you really love him you will prob think youll want to egnolage it	It depends. If you really love him you will probably want to draw it out.
If you or the other person is married, RUN!!!!	If you or the other person is married, run!
No men don't but little boys do	No, men do not, but little boys do.
Help me win this debate with her !	Please help me win this debate against her!
My girlfriend's the nuttiest, but I love her anyway.	My girlfriend is strange, but I love her anyways.
simple enough, do like anyone else does.....play with it.	It is quite simple, just do what everyone else is doing.
sweetheart let him go ,if he is ment to be with u he will come back to you	It is time to forget about him, if you two are meant to be he will return to you.
Of course after 3 day of that my back went out LOL.	After three days of that activity, I began to have problems with my back.
stay alive and get your old life back.	Stay alive and get your old life back.
So thats why I ask why dont guyz ever know what they want with any kinda relationship!?!?!	That's why I ask, why don't guys ever know what they want with any kind of relationship?
Maybe ask him out to lunch or a movie or somthing.	You might ask him out to lunch or a movie or something.
Girls don't like guys who is all about themselves.	Girls don't like guys who are all about themselves.
it depends do u like either one???	It depends, do you like either one?
I was always looking and I kept picking jerks.	I keep going on dates with men who turn out to be rude.
so, no i feel its a choice and one does what feels comfortable to them.	It is a choice, and you should do what is comfortable to you.
Some do,some don't have it in them.	Some people do not have it in them.
Just do what makes you happy!	Do what makes you happy.
because for some reason i cannot	I can not go.
So it would have to be love.	Therefore it must be love.
because....you know.......try to search you love.....but becareful.....!!!!!!	As you know, you should search for love but carefully.
don't ask her to perform some act for you, make her the spotlight.	Do not ask her to perform an act for you; make her the one being noticed and adored.
girls are simply impressed if u can show a little care, respect and honesty to them.	Women are impressed if you show care, respect, and honesty towards them.
Tell the bastard to GET OUT.	Tell the rude man to leave.
they think it is the only right way!	They think that way is the only right way.
Good luck and keep it cool!	Good luck and stay calm.
That said u need to figure out youself if u want to stay married to him.	If you want to stay married, you need to find yourself.
And I hate him for it.	I do not care for him.
Men like this, typically become wife beaters if you don't OBEY them!	Men with these characteristics typically become wife beaters if you disobey them.
First off, I have 4 kids....so a homemaker is more work than my job even.	First of all, I have four kids, so being a homemaker is more work than my regular job.
no i haven't..i prefer normal-looking guys	No, I have not. I prefer normal looking guys.
it defenetely looks like he has feelings for u.do u show how u feel;;u should!!	It definitely looks like he has feelings for you. Do you show him how you feel? You should!
everything seems so open and hit and run with most people these days.	Everything seems so open and hit and run these days with most people.
i have a problem of unloading all my junk up front and maybe i told this guy to much.	I have a problem in that I unload all of my junk up front. Perhaps I told this guy too much.
the right date can save money on lots of things.	The right date can save money on plenty of things.
If you truly love your man & want to work it out then tell your X to respect that.	If you truly love your man and want to work it out, then tell your past partner to respect that.
That only makes her easier to bed.	That only makes her easier to have sexual intercourse with.
Don't think you should try it!	I do not think you should try it.
simple...honesty and love and try to true with them	Simple honesty, love, and trying to be true to them.
i hoping for at least a 90% but realistically i think its more like 70% or 65%.	IT is more like 65% or 70% and not 90%.
but cuddling up with a large women is one of the best feelings i know of.	I like the feeling of cuddling with a large woman.
And women also expect guys to act like that, so why should they grow up?	Why should men grow up if women expect men to act like that?
A couple of ways: -  Get him drunk.	You can get him drunk.
The problem is not if u ask her while at work or not.	Is is not a problem if you ask her while at work or not.
Stick with the 13 & 14 year old boys .. they are easier to control anyway.. LOL Good luck	Stick with the thirteen and fourteen year old boys, they are more simple to control anyway, good luck.
YOU NEVER LET A MAN  MISTREAT YOU	You never let a man treat you the wrong way.
PS Im not a stay at home romantic dinner type of girl.	Also, I am not a stay at home, romantic dinner kind of lady.
!,anyway when i left him i swore i,d never get married again!!	When I left him, I swore I would never get married, again.
pickup lines are tacky..just be yourself and complament her alot..women like that	Pickup lines are unseemly. Be yourself and compliment her a lot because women enjoy that.
You'll be fine just have fun!	You will be fine. Have fun.
not all the time, sometimes men shave them, it depends on the woman,	Not all of the time. Sometimes shave, it depends on the woman.
i love him but i think im ready to move oe, meet new guys!	I love him but I think I am ready to move on and meet new guys.
so wait for another 4 years.	Wait another four years.
I hope I see some of it soon.	I hope I can see some of it soon.
I don't want to be mean.	I do not want to be mean.
also u shood wait a while b for having kids.	You should wait a while before having kids.
i would like to have some fun with u that's why i answered this stupid question	I would enjoy having some fun with you, that is why I answered this silly question.
try to contact their q&a team..they'll help you through..have a nice day!	You should try to contact their question and answer team and they will help you through it; Have a good day!
Because womens don`t put out often...	Because women do not have sex often.
if he insists, it means he only after sex.	If he insists, then it means that he only wants to have sex.
B) Looks definitely matter, anyone saying they don't is probably lying.	Looks definitely matter and anyone who says that they do not is likely lying.
Whle MAKING LOVE is like living a fantasy.	Making love is like living a fantasy.
when you 18 or 20 because when they said something they dont mean it	When you are 18-20, sometimes you say what you do not mean.
when possible, try to make it yourself.	Try to make it yourself, when possible.
But (there's always a but isn't there?	There is always an exception, correct?
If she is not into you anymore...	She is not that into you anymore.
i seriously doubt that you are in love with that many guys.	I seriously doubt that you are in love with that many men.
on average id say about 45% at first but than one you get to knowthe person maybe 15%	On average, I would say about 45% at first, but then once you get to know the person, perhaps 15%.
Play sports with your guy friends.	You should play sports with your male friends.
She will tell you if it's not OK.	She will tell you if it is not alright.
I don't mean, do you think women are sexy and beautiful.	I do not mean, do you believe women are beautiful?
how do i get he to stop nagging me and leave me alone.	How do I get him to stop bothering me and leave me be.
a sex toy, that way you can both enjoy it.	An intimate, adult toy, that way you can both enjoy it.
men without hair look like little boys to me, and it's not sexy at all.	Men that do not have hair appear as little boys to me, and it is not attractive whatsoever.
i agree, just kiss him... he'll respond one way or another.	I agree, just kiss him, he will respond either way.
a good way is to imagine yourself without him/her.	A good way is to try and imagine yourself without him or her.
here in America it is not so important...	It is not so important here in America.
well if it was before you then he wasnt cheating at all... obviously.	Well, if it was prior to his relationship with you, then obviously he was not being unfaithful at all.
man how many times I passed up a great oppertunity by worrying about someone saying No......	"Man, how many times have I passed up a great opportunity because I worried about someone saying ""no"" to me?"
Because the white women are taking up all the men!!	Because the white women are taking up all of the men!
ur self image is also very important.	Your self-image is also very important.
Have you ever had a PAP smear.	Have you ever had a PAP smear?
good god how old are you ?	Good god how old are you?
but i think they both like me.	But I think they both like me.
Okay well first thing it sounds as if YOU GUYS ARE ALREADY MARRIED!.	Ok, first thing is that it sounds as if you guys are already married.
yes jaime is going to ask rubi out.... but it is not yoru business...	Yes, Jaime is going to ask Rubi out, but it is not your business.
that is a sign, things like that can make it really obvious	That is an indication. Things such as that can cause it to be readily apparent.
u should take the time to get to know both of them equally without goin out with them.	You should take the time to become acquainted with both equally without dating either of them.
i'd love to hear logical opinons on this, thanks	I would be very pleased to hear logical opinions on this topic. Thank you.
If you like the guy then go for it.	If you care for the man then proceed.
Having FUN with guy friends is OK.  1.	Enjoying yourself with male friends is acceptable.
So its natural with that guy.	So it is natural with that guy.
women take on alot and sometimes they feel like they do it for nothing.	Women take on too much, and sometimes they feel like they do it for nothing.
no, because i'm not married yet	No, because I am not married yet.
let me know what you think, thanks	Let me know what you think.
If you are gay BE GAY!!!	If you are a homosexual then be a homosexual.
good luck and hang in there.	Good luck and do not give up.
i like older girls so i think this is sick and wrong that they cant go out with her	I like older women so I believe it is strange and wrong that they cannot go on a date with her.
i am just curious to what everyone thinks.	I am merely curious about what everyone thinks.
my last bf i met driving round a roundabout in another car!!	I met my previous boyfriend by driving in a roundabout in another car.
becuz if you do then your gonna lose your friend over a guy!!!!	You are going to loose your friend over a guy.
It really was a casual aside when I said it -- I didn't think he would remember.	I did not think he would remember, it was casual when I said it.
are you a country girl or a city girl.	Do you like the country or city?
hang out all day together and to top it off touch his feet.	You can be together all day, and touch his feet.
im very bored bein single.sittin back watchin other gurlz hava all da fun!	I do not like being single. I watch everyone else have fun.
)women are curious about sex with other women, even me!	Women are curious about sex with other women, even myself!
I don't know what you said because I was to lazy to read your typing.	I do not know what you said. I was too lazy to read your response.
i hate it my self, i love the straight ones	I hate it. I love the straight ones.
This is Doc Izzy and I love and adore bigger women!	This is Doctor Izzy speaking.  I love and adore plus-size women!
there are not any words that are going to make it any better.	No words will make the situation better.
do it before it is to late	You should take action before it is too late.
well to tell u tha truth u learn but u have to actually do it.	To tell the truth, you will learn, but you must experience things.
Nay Pier is a great place or one of the museums....there r alot of great resteraunts of hotels.	Navy Pier and the museums are great to visit.  There are also many great restaurants and hotels.
thats a stereotype( not a country girl by the way)And I think Im sexy in my own way.	That is a sterotype, and I am not a country girl. I think I am attractive in my own way.
he wont turn you down .	He will not turn you down.
well i hope you read this really well.	I hope you read this well.
lots of men like thick girls, most of them are black.	Many men prefer curvy women, most of them are African American.
If she's interested she'll call later.	If she is interetsted, she will call you later.
No, you won't because you know he has cheating tendancies.	No, you will not because you know he has cheating tendencies.
Ask ur self that, if you know what I mean.	Ask yourself that; if you know what I mean.
I find if I try real hard I can see things I know aren't there normally there.	I find that if I try really hard I can see things I know are not there normally.
Lets get coffee and chat and take it from there!	Let us get coffee and talk, and we will take it from there.
just move on with your life and frind some one eles!	Just move on with your life and find someone else.
ILL BET YOUR NOT, BUT TRY TO EMAIL ME ATILIKETHICKCHIX@YAHOO.COM AND I WILL BE HONEST.	I will bet that you are not, but try to email me at ilikethickchix@yahoo.com and I will be honest.
Me and this boy been going off and on since last year.	This man and I have been on and off since last year.
I really care about you and I can't stop thinking about you.	I really care about you and I cannot stop thinking about you.
is worth  the wait when you are ready.	When you are ready, it is worth the wait.
if you don't know ask someone who would.	If you do not know, then ask someone who would.
keep away ur fear and tell him.	Push away your fear and tell him.
thats a chance your gonna have to take.	That is a chance you are going to have to take.
So if you want to be attractive to losers, creeps, and pervs Drink up!	So drink up, if you want to be attractive to losers, creeps and perverts!
not for anything but lookin at	Good for nothing, but enjoying visually.
After i while i t passes and i still love him	After awhile it passes and I still love him.
IT'S YOUR OWN LIFE, AS YOU SAID.	As you stated, it is your life.
(and now even in devorce im stuck with it !	Even in divorce I am stuck with it!
just because he has the potential to be a great boyfriend doesnt mean he is.	Just because he has potential to be a great boyfriend does not make him one.
sure let me know more 'bout you	Sure, tell me more about yourself.
when one minute you want to throttle the other person & the next you want to jump their bones	One minute you want to throttle the other person and the next you want to jump on them.
the girlz that are pretty or have a great personality.	I like girls who are pretty or have a great personality.
Ppl whose parents well take care of them, big time lazy ppl.	People whose parents take care of them can be very lazy.
i do not know what she wants.	I do not know what she wants.
it is very complcated tell it again please but in simple	That sounded very complicated.  Please tell it again, but in simple terms.
Show her what you're good at.	Demonstrate your skills to her.
if u can imagine him as the father of ur children !	If you can imagine him as the father of your children.
If you dont ask sombody else might.	If you do not ask someone else then I may.
Haha thats why I am single!	I am laughing because that is why I am single.
if you really love him, you would let him go...	If you really do love him, then you would allow him to go.
if she doesnt want to be with you- try to be her friend.	If she does not want to be with you, then try to be her friend.
well if he says he isnt believe him.	Well, if he says that he is not, you should believe him.
Lets get it out of limbo ;)	Let us get it out of the uncertain part.
I even worked there for awhile and met the man of my dreams.	I worked there for a time, and met the man of my dreams.
I'VE BEEN WITH MY HUSBAND FOR 4 YEARS WE RECENTLY GOT MARRIED IN DECEMBER OF 2005.	I have been with my husband for four year.  We just recently got married in December of 2005.
focus on how things are and what would be best for you right now.	Focus on how things are and what would be best for you at this moment.
u'll see that no matter how hurt u r it's still the simplest reason y u smile.	You will see that no matter how hurt you are, it is still the simplest reason as to why you smile.
Wow I didn't think Pakistan is that conservative.	I did not think that Pakistan was that conservative.
i have to stop right away because i'm ready to relieve myself.	I have to stop right away because I am ready to relieve myself.
WHATEVER YOU DO...DO NOT TELL HIM TOO SOON!!!	Do not tell him too soon.
We can't answer if she really means it.	We cannot answer if she means it.
i dont like a guy dat does dat all da time.	I do not like men that does that all of the time.
then u can make an easier decision.	You can make an easier decision, then.
I have sexed many girls and some where whores.	I have had sex with many girls and some where not the best quality.
he dribbles... he shoots... he scores... 2 points...	He dribbles, he shoots, and he scores two points.
TALK 2 YOUR BEST FRIEND AND SEE IF ITS COOL	Talk to your best friend and see if it is alright.
is this a trick question ?	Is this a trick question?
I don't know can I do anything about it?	I do not know. Can I do anything about it?
people are HUSBANDS and WIVES for REASONS!!!	People become husbands and wives for real reasons.
if he doesn't then there are too many fish in the sea.	If he does not, then move on, there are way too many fish in the sea.
or just you wanna say that!?	Do you want to say that?
If you aren't happy fix it or get out.	If you are not happy, you need to fix it or break up.
not all guys, but some guys do	Not all guys enjoy that, but some guys do.
I totally agree with Udaman...good luck girl	I agree with Udaman.
SOUND LIKE YOU LIKE TO SELL YOURSELF TO MUCH.	It sounds like you are selling yourself too much.
Your girlfriend will just think you're a jerk.	Your girlfriend will thing that you are a jerk.
sometimes but you have to observe the one you call your man.	Sometimes, but you must observe your boyfriend.
Replaying everything you ever did to me?	Replaying everything you ever did to me, correct?
But don't just sit around waiting for the phone to ring.	But do not merely sit around waiting for the phone to ring.
I dated a guy this past year and he got to the a violent point.	I was in a relationship with a man earlier this year and he became violent.
Leave it alone-I don't care what she says, she's in enough pain.	Leave it alone. I do not care what she says. She is in enough pain.
how would anyone know if they don't know anything about you?	How would anyone know if they do not know anything about you?
Just find one that loves you too.	Just find one that loves you too.
it never hurts to be flirty!	It never hurts to flirt!
we was hangin out a lil.	We were spending a small amount of time together.
Don't use pick up lines , that's a turn off .	Do not employ flirtatious dialogue; such behavior isn't appealing.
i love them b/c im a guy and i dont have to ask anyone to the dance	I adore those people since I'm male and I'm not required to invite a date to the affair.
girl there are more guys out there that love thick girls than u think?	Woman, more men exist in the world with a fondness for overweight women, contrary to your beliefs.
The girls that whine that flowers don't last are just ungrateful.	The females that complain about the short existence of flowers are simply unappreciative.
u need to be wit that person, you have found your true love	You need to be with that person; You have found your true love.
and i mean Really be her friend.	I mean you should truly be her friend.
how do I get my sweetheart to show me he loves me	How can I get my sweetheart to show me that he loves me?
WELL BASICALLY YOU HAVE TO STOP TALKING TO HIM AND STOP THINKING ABOUT HIM	The bottom line is that you have to stop talking to him and stop thinking of him.
they never met but she says they're in love.	They have never met in person but she says they are in love.
Don't do this over the phone, email, etc.	Do not do that over the phone or email.
i'm not against gayz and lez's they are the best friends a person can have.	I am not againt homosecuals, they are very good friends.
imet a girl and i want to know how to know if shes into me or not	I met agirl recently, and I want to know if she likes me.
Death is like a box full of candy corn	Death is like a box full of cnady corn.
just try and make the best of what's to come.	You need to try and make the best of what is going to come.
Either you move on with your life or you try to make it work with this person.	You need to move on with your life, or try to make it work with this person.
She's the love of my life and I can't wait to spend the rest of my life with her.	She is the love of my life, and I can not wait to spend the rest of my life with her.
because women think with their brains.	Since females experience thought via their brain activity.
I'm still in love with my ex and I'm so mad at my cousin because my ex likes her.	I still have feelings for my ex and I'm furious with my cousin due to my ex now liking her.
Only time will tell spend time with friends have fun don't thimk sbout it	The passage of time will reveal the truth. Socialize with buddies, enjoy yourself, put it out of your thoughts.
Thats why I do not get in chat rooms anymore, unless its to laugh at all the freaks.	Therein lies the reason for my nearly non-existent chatroom attendance. I rarely go, save for a desire to be amused by the weirdos.
ohhh this is what i did - big bad mistake on my part.	This is what I did, it was a big mistake on my part.
I have no idea where to begin!!!	I have no idea where to begin!
But he chaeted, so i guess I can lift or carry my husband.	He cheated, so I guess I can carry my husband.
if she is calling just to bablle then tell her to not call you so often!	If she calls just to ramble then tell her not to call so often!
thats all i have 2 say.	That is all I have to say.
you shouldn't be asking this question?	Do you think you should be asking this question?
i was also thinking about lime green.	Another option that I am considering is lime green.
I mean the both of you together.	I am referring to the two of you collectively.
I have a close girl friend.	I have a woman who is a close friend.
Wanting to be something they're not?	Are you wanting to be someone you are not?
well, if u can imagine ur self with him in bed @ night!!	Can you imagine yourself in bed with him at night?
they like the challange i know thats what i love about it	I love that they like the challange.
depends on the girl I guess... fair skinned females look extra pale when they have black hair.	It depends on the girl. Fair skin ladies look extra pale if they have black hair.
Oh man i should do that when im dating next time!	I should do that, the next time I am dating someone.
Don't listen to what anyone else tells you to do.	Do not listen to what anyone else try to tell you to do.
I really like this guy, and I don't know if it's just a crush, or if I love him......	I really like this man.  I am not sure if it is love or just an infatuation.
i think the Bomb is much easier!!	In my opinion, the bomb is much easier.
Not always the easiest but they have been pretty good years.	They have been fairly favorable years, not always the easiest.
DONT FORGET TO CHOOSE AND VOTE FOR BEST ANSWER!!!	Do not forget to choose and vote for the best answer!
..... You tell her why you like her!	Tell her why you like her!
Did  turn gay or is it a curiosity thing?	Did you turn gay or is it just a curiosity thing?
No, Not if you have to ask.	No, not if you have to ask.
the list could go on and on.	It is a very long list.
But he might enjoy all the waiting, dreaming & teasing.	He might enjoy the waiting, dreaming, and teasing.
Don't eat where you take a s***.	To not get yourself into trouble.
of course you do wanna chat hit me up fla_cat_blue@yahoo.com	If you would liek to talk, message me.
When he teases you about the stupid little things.	He likes to tease you abut pointless things.
if u think that he feels the same way about you, why not?	Do you believe he has the same feelings towards you?
well, in my experience, a lot of the time one of them ends up cheating on the other.	From personal experience, most of the time someone ends up cheating on their partner.
They are often worse than men!!!	They are often much worse then men.
I've heard of friends getting married about 6 months after meeting somebody.	I've heard from a few friends, that they've gotten married six months after meeting someone.
i don't know what u mean.	I don't know what you mean.
If you want kids, then homemaker.	If you want kids, then homemaker.
what's the worst that could happen.	What is the worst that could happen?
Intellect - a chick with brains is just sexy!	Intellect, a chick with brain is just sexy.
his/her intelligence,the way they carry themselves,good looks and activeness	His/her intelligence, the way they carry themselves, good looks and activeness.
sure...and will you pay mine too????	Yes, will you pay for me as well?
YES all i can say.. but yes, i have long black hair and im proud!!	Yes, I am proud of my long, black hair.
I was NOT gonna let her win.	I was not going to let her win.
Chances r, if u like her as a friend, ull like her as more.	Chances are if you like her as a friend, you will like her if you are in a relationship.
JUST BE YOURSELF WHEN YOU ARE WITH HER.	When you are wither her, just be yourself.
guys think that they are special, and that they are only good enough for certain girls.	Men think they are special and that only certain women are good enough for them.
find someone u like and say will u be my valentine!	Find someone you like and ask them to be your valentine.
Post more questions on Yahoo Answers!	Post more questions on Yahoo Anwers!
Well,if the one boy picks on you, why like him?	Well, why do you like the one boy who picks on you?
Brokeback Mountain ,ok it's a guy but at least you'll be happy!	I would say Brokeback Mountain; you will be happy even if it is a man.
size, shape,looks, ect should NOT matter at all...	Size, shape, looks, and other surface features should not matter at all.
SEX IS NOT THE ONLY THING IMPORTANT IN LIFE DAMN IT!!!!!	Intercourse is not the only important thing in life.
you're probably just too good for him anyway.	You are most likely too good for him.
you like him or you don't like him?	Do you like him or not?
why dont you just ask her if you can kiss her?	What's the reason for not simply requesting permission to exchange kisses with her?
Whos to say that country girls feel more sexy?	Who's qualified to classify country women as possessing more sex appeal?
Well i dont no how old you are which would help.	Well, I have no knowledge of your age, which would be of assistance.
Just think about what you like and do it back for them....kinda like a tounge massage.	Merely contemplate those things you enjoy and provide the same in return, somewhat akin to a massage performed with one's tongue.
Here's my answer: A) MOST guys definitely do not prefer girls that are skin and bone.	My response is as follows: (A) The majority of men have no affinity for seriously emaciated women.
CUT YOUR COUSIN AN YOUR EX BOYFRIEND OFF COMPLETE.	You must cut your cousin and ex boyfriend off completely.
or does his friends point at you when your with him.	Does his friends point at you when you are with him?
YES IT IS VERY POSSIBLE TO ENJOY GIVING PLEASURE RATHER THEN RECIEVING IT	It is possible to enjoy giving pleasure instead of recieving it.
Now I keep thinking of getting it on with a girl.	I keep thinking about being intimate with a girl.
depends on if they are brunette or not	It depends on if they are brunette or not.
is she just trying to use you?	Is she simply trying to use you?
U can have a big u-no-what, n suck in bed.	You can have a big penis and still be bad in bed.
get rid of the x if you are dating the guy you love right now.	Get rid of the ex if you are dating a man you love right now.
It hurt like hell and I bled.	It hurt extremely badly and I bled.
cuddling, kissing, fondling, playing with each others sex organs before sex.	Cuddling, kissing, fondling, and petting one another before sex.
when he does explain to him that it was a mistake to break up and want him back.	When he does, you should explain to him that you want to be with him and it was a mistake to break-up.
My bf loves me to death and doesnt want to give me up.	My boyfriend loves me a lot and does not want to give me up.
you are already doing it so why yet bother?	You are already doing it, so why bother?
on the hood of my car at a waterfront in a light rain it was awesome!	It was impressive on the hood of my car, at a waterfront, in a light rain.
I think you are probaly a nice guy and she probaly loves you alot.	I believe that you are likely a nice man, and she likely loves you a lot.
your looking to hard, or maybe you're looking in the wrong places... sign up for yahoo personals	You are searching too hard or possibly looking in the wrong places; Sign up for Yahoo Personals.
only if you want it to be.	Only if you desire it.
But if she doesn't have a reason then she isn't ur friend!	Though if she does not have a reason then she is not your friend.
you have to find whats right for you and your partner/s!	You need to find what is right for you and your partner(s).
you are definitely not a hoe, don't worry.	You are definitely not a promiscuous woman, so do not worry.
GIRLS DON'T THINK IT'S COOL, THEY THINK IT'S GUYS WHO SMOKE ARE PATHETIC COS THEY ARE KILLING THEMSELVES	Girls to not think it is cool. They think that men who smoke are pathetic because they are killing themselves.
So - U like asian food?	So, do you like Asian food?
they don't mean to get them pregnant they just can't keep it in there pants because they are PIGS!!!	They do not mean to get them pregnant. However, they cannot keep it in their pants because they are pigs!
I like natural / real girls, I don't like fake looking prissy drama queens.	I like natural and real girls, not fake-looking, prissy drama queens.
)take on how the world works, and their desire to catch up	Take on how the world runs, and their desires to catch up to the ever expanding world.
that's too many, and selfish ,indeed.... u just desperate n keep on trying another one right?	That is too many, and selfish, you are desperate to try another one though, correct?
its like if you decide to eat chocalate and then moan cuz u look too fat.	It is as if you decided to eat chocolate, and then complain about appearing overweight.
Do you know he loves you?	He loves you; you are aware of that?
my wife forgives me for alot of things .	My wife is a forgiving woman.
FIRST YOU ORDER ONE ONLINE AND THE STORK BRINGS ONE TO YOU	You order online and then the store brings it to you.
i would say around 3 or 4	Around three or four.
Imagine that i am that guy and be MY girl freind!	Imagine that I am that man and be my girlfriend.
give them a chance to discover you.	Offer them the chance to discover you.
its unusal yes, but nothing bad.	It is unusual, yes, but not bad.
I still love him what to do	I still love him. What should I do?
Don't just stay with him for the baby.	Do not remain with him solely for the child.
and never ignore her always listen to her...and when you do don't change the subjetct women hate that.	Never ignore her, always listen to her, and never change the subject.  Women really dislike that.
IT CAN BE GOOD LUCK ALSO IF YOU TAKE IT AS GOOD LUCK.	It can be good luck if that is the way that you want to look at it.
ITS a man thing live with it EGO	Egotism is a man's attribute, you just have to live with it.
Sounds like u r going through a lot right now.	It sounds like you are going through a lot right now.
Good luck but DO YOUR HOMEWORK!	Good luck but be sure to do your homework!
Don't come here, it smells like a trap to me.	Do not come here because it seems like it is a trap to me.
Everywhere.... Just ask any girl passing by.... but ONLY IN THAILAND....  not in US .... lol	Everywhere! Just ask any girl passing by in Thailand, but not in the United States.
This gal does NOT want a bad boy at all.	This girl does not want a bad boy at all.
But I need to be happy.	But I really need to be happy.
you are so full of it, teasing all these desperate lonely sad sad guys, shame on you	You are being dishonest by flirting with these pathetic desperately lonely men and you ought to be ashamed.
Also sometimes guys think they dont need you so bad until your gone.	Additionally, men sometimes think that they do not need you much until you are gone.
only that i can say: good luck!	"The only words I have are ""Good luck!"""
you married your hubby hopefully because you love him .	You married your husband, I hope, because you love him.
I LOVE TO EXPRESS MY FEELINGS TO  THE LADIES WITH POEMS,  HAS ANYBODY WRITTEN ONE FOR A SPECIAL SOMEONE.	I most enjoy expressing my feelings to women with poems. Has anyone written one for their significant other?
Why tie yourself to just one guy?	Why limit yourself to only one guy?
That's if u both agreed on doing this.	Have you both agreed on doing this?
It's like saying, What's got to stop me when I have already done it?	What is going to stop me when I have already done it?
he just has to start over and earn your trust again.	He has to start over and earn your trust again.
One his side of his family I met his father.	I met his father in his side of the family.
we fall in love  they treat us bad  why are we there	We fell in love with them, and they treat us terribly, why?
i am one of those who want to wait until being totally in love with someone.	I am one of those people who want to wait until they're in love with someone.
But try the nice way first..girls hate being ignored!	Try to be nice first, women don't like being ignored.
keeping secrets only hurt the ones you love.	You will hurt your loved ones if you continue to keep secrets.
Some women like big hairy guys, some guys like fat women, some gals like skinny guys, and vice-versa.	Some women like hairy men, some men like fat women, some women like skinny guys and vice-versa.
curves, esp if they have big boobs, and softness........can't beata soft woman	Curves, especially if they have ample breasts and are soft. I cannot beat soft women.
never tell her she's fat big one!!!	Never tell her she is fat.
You are a MOM, Act like One!!!	You are a mother, please act like one.
OTHERS LIKE THINK DUE TO SOCIETY DICTATES ITS; I SAY SCREW SOCIETY AND GIVE ME THICK!	Others believe society dictates what others think, but I do not care.
give them 2 months they will get over you.	I give them two months. They will get over you.
Don't know, but daniel K has never read manga.	Do not know, but Daniel K has never read Manga.
I guess it's kind of nice, it's like your dad's blessing all the way.	That is good, it is similar to getting your father's blessing.
I like intelligent,fun and hot girls.	I prefer intelligent, pleasant, and captivating women.
come to my town ill be your girl....	I will be your significant other is you come to me town.
This generation is just too stupid.	This generation is not too bright.
Yeah, time to cash in your chips.	You will have to pay the price.
They are always in the 'in love' stage.	They are very much in love.
i see a malaysia air ad on tv and i go gaga.	Every time I see an advertisement for Malaysia Air, I go crazy.
it was really nice how he asked me out.	He asked me on a date in a very nice way.
TRY TALKING TO HER AND ASK HER TO HANG OUT AS FRIENDS SEE IF IT GOES SOMEWHERE	Try talking to her and asking her to hang out as friends.  See if the relationship ends up going somewhere.
(this is really hard because there are a lot of temptations out there).	This is a very hard choice because there are many temptations.
Not what you can become just because she says too.	Not what you could become just because she says so.
the two of you should talk privately and personally...you have to clear each other's side..do it now	Both of you should speak privately and personally, you need to clear each other's side, do it now.
Well, the one I liked goes like this.	Well, the one I enjoyed goes something like this.
Do not try to have sex.	Do not attempt to experience sexual relations.
just keep it cool, a little hard to get might help!	Just stay calm, a bit of hard to get may help!
if your relationship survive the four seasons... i guess you should be ready....	If you relationship lasts a year, I would assume you should be ready.
I married my guy anyways and do you know why (besides love).	In any event, I married my husband, and wonder if you know the reasons in addition to love.
move on and find someone who doesn't hate you.	You need to move on and enter a relationship with someone who does not hate you.
YOU CAN'T, so lets just start asumming it.	You cannot, so let us operate on an assumption.
yes we like flowers, pretty, good smelling ones	Yes, we like flowers that are pretty and smell nice.
should i or shouldn't i. younger guy vs older woman	Should I date him or not?  It is a younger guy vs an older woman.
ok, those other replies are just cocky, i'm way more FINE.	Those other replies are cocky.  I am a much better person.
lime green would be more for a summer wedding.	Lime green would be best for a summer wedding.
but if they cannot exercise self-control, let them marry.	But let them marry, if they cannot exercise self-control.
My boyfriend snores and I have the most terrible time sleeping!	I have the most terrible time sleeping, because my boyfriend snores!
May be u think not but Yes!!!	You may not think so, but yes!
WE HAVE NO ROOM FOR SCREWED UP ANIMALS LIKE THIS IN OUR SOCIETY.	We have no room for messed up individuals like this in our society.
The best way and easiest way is to fly or drive to Las Vegas and get married there.	The best and easiest way is to fly, or drive, to Las Vegas, and get married there.
his answer is good enough for me...	His answer is good enough for me.
no single man can give you what you really want.	No single man can give you what you want.
if he doesn't start acting right, then leave him.	Leave him if he does not start acting right.
if yor hott too show him your boobies	If you are attractive you can show him your breasts.
a lot of guys like that - just looking for sex.	A lot of men are like that and are just looking for sex.
(i mess up alot at times ) but she don't forget.	(I make a lot of mistakes), but she does not forget.
WAIT FOR HIM TO ASK U OUT UNLESS UR REAL DESPRETE	Unless you are desperate, wait for him to ask you out.
u are asking do u like me	Are you asking if I like you?
Whatever  you decide, make it completly YOURS!	Make sure it is your decision.
her parents?u can't fix it... her friends?maybe u can talk to them nicely...but, pls specify , why?	Can you get someone to help her- her parents or friends?
How drunk is this girl getting?	How intoxicated what she?
gals luv guys with positive self image.	Women love men who are self confident.
am doing this just for the points lol	I am doing this for some points.
if ya'll don't know anyting about each other u can't connect.	If you don't know each other well, then there is no way you would connect.
If you do... then i would say it was a real and worth realtionship  :)    Good luck	I would say that is was real, and is worth having a relationship. Good luck to you!
but really if you're used to it and you kinda like it, go with it.	But if you are used to it and you enjoy it, then go along with it.
cause it's buy one take one.	Because it is buy one, take one.
AND LAST BUT NOT LEAST--- does he always just happen to be staring...?	And lastly, does he always happen to be staring?
It sounds like a con, but i'm telling you, chicks dig it.	It sounds false, but I swear, women enjoy it.
you just have met the dumb ones out there that think skinny is better.	You have the unintelligent ones out there that think skinny is better.
However, i always believed in the fact there's a huge different between HAVING SEX and MAKING LOVE.	However, I always believed the fact there is a huge difference between having sex and making love.
You just have to make yourself walk away.	You have to make yourself walk away.
in my case i think 80%	In my case, I think around 80%.
leaning in and giving me a soft kiss just on the forehead.	I like it when they lean in, and give me a soft kiss on the forehead.
I can't see my life without my husband.	I can not see life without my husband.
I do....much prettier and smooth as silk!	It is prettier and smooth as silk.
:) Although, flowers are really nice even if they don't last.	Flowers are nice, even if the do not last long.
it sounds like he is having too much fun while you are away.	It is sounding like he is having too much fun while you are away.
WHY don't you just leave the girl alone?	Why do you not simply leave the girl alone?
Maybe you should try dating girls if guys offend you so.	Maybe you should try dating girls, if guys offend you so much.
i also have not a single girl friend .	I also do not have a single girlfriend.
Just remeber,     s go for guys who are themselves and ONLY themselves!	Just remember: go for men who are themselves, and only  themselves!
they feel that they are better than womans but there wrong	They feel that they are better than women, but they are wrong.
That doesn't mean you should let them in.	That does not mean that you should let them in.
It's always in the back of my mind.	It is always in the back of your mind.
does she have other friends to gab with on the fone?	her friend to talk with her on the phone?
Getting married and getting child can wait but studies can't.	Getting married and having children can wait, our studies cannot.
But you need to do this a few times.	You need to repeat this a few times.
most teen boyz prefer girls that like sex.	The majority of males prefer females that enjoy sex.
Don't look back and enjoy the friends you have.	Don't look back. Enjoy the acquaintances you currently have.
NO GOOD OR BAD IS YOUR PERSONAL BELIEF ON SOMETHING.	No greater good, nor bad is your own personal belief.
and i dont know what i should do.	I'm unsure concerning what I should do.
yes it is a sick habit	Agreed, it is an unhealthy behavior.
wait till you get 25. you would not loose your charm by then.	Delay doing so until you reach age 25. Your appeal will not diminish in such time.
My bff hates my b/f and wishes for me to break up w/ him but I won't.	My eternally close friend despises my partner and hopes for the dissolution of our relationship, but it will not occur.
RELAX AND BE REAL THAT IS WHAT WE LIKE.	Be authentic and restful. Such behavior is that which we enjoy.
i dont think so, maybe they should try taking our last names	They should try taking our last names.
You both should pick either his or yours once you have kids.	Once you have children, you will need to decide on a last name.
Of course HE wants to go on.	He wants to continue.
So I guess I pick domestic goddess.	I pick the domestic goddess.
Ask her out after class again.	Ask her for another date after claess.
and people life is to short live it to the fulliest and have faith	Life is too short, so live it to the fullest and have faith.
I am man and I too feel so.... because I too am !!!	As a man, I feel the same way because of who I am.
IF YOU LIKE HIM THAT MUCH,CALL HIM.	Call him if you feel that level of attraction to him.
start with a basic everyday question and go from there :)	If you start with a basic question, you can go from there.
tell more ppl (my bor did)	Did you tell more people?
all my friends want to do is makeout!	My friend want to kiss their boyfriends.
also actual kissing and asking if your a good kisser...	You can ask if you are a good kisser.
we will not regret it.at ur service anytime.	I am at your service anytime, we will not regret it.
u need to reput it in add it back just like first time	You need to put it in again and add it back, just like the first time.
You can share this with ur mom or dad.	You can share this with your mom or dad.
And don't fall for the alcoholic only on weekends line that the guy above is giving.	"And do not fall for the ""alcoholic only on weekends"" line that the guy is giving you."
you sorta stuck yourself out thier to get hurt, unless you know him fairly well.	You sort of put yourself out there to get hurt, unless you know him fairly well.
I prefer A & B cups, myself.	Personally, I prefer A and B cups.
be her friend first then see where it goes	Be her friend first, then observe where it goes.
dont even listen to what people not just guys say,  watch how they act.	Do not even listen to what people, not merely males, state, but observe how they act.
do u fell that way ?	Do you feel in that manner?
but if a guy asks u dont be afraid to say NO.	Alas, if a male inquires of you, do not be frightened to state negatively.
Obviously she don't want you if you know she likes the other boy!	Obviously, she does not desire you if you know she is partial towards the other male.
There are lots of things that make a woman not like sex.	There are lots of things that make a woman dislike sexual intercourse.
Not all guys get bored and move on.	Not all men get bored and move on.
BUT --  There's no better person to marry someday than your best friend!	But there is no better person to marry someday than your best friend!
depending on what yo uare looking for, freindship only, like.	Depending on what you are looking for, the relationship may be friendship only.
i did this with my current boyfriend.	I did this with my current beau.
But it doesn't mean you cannot love another.	It does not mean that you cannot love another.
just divorce that guy... he has no honour and he dont love you.	In my opinion, you should divorce that man, he has no honor and he does not love you.
basicaly men just want to have girlfriend for free sex!!!	Basically, men just want a companion for unfettered copulation.
if nothing work ... u have to ask him for it again  :-)	You will have to ask him for it again if nothing else works.
its ur PERSONALitie, keep to it, whether a guy goes out with u shouldnt determin how u act.	It is your personality and you need to keep it; Whether a boy goes out with you or not should not determine how you act.
you have to search yourself for this one...	You have to look within yourself for the answer.
If the Guy is worthy enough, u wont need to	If the man is worthy enough, you will not need to.
I'm confused I hate the girl to be like that ... what shall I do ?	I am confused and do not know what to do because I hate for the girl to be that way.
shop around for invitations and everything else!	Shop around for invitations and anything else.
he then asked me, can i come with you?	"He then asked me ""Could I come with you?'."
Just go with your feelings if you like her so much then go with it.	Just go with your feelings. If you like her so much, then go for it.
So I'm only myself around guys I dont like, and you know the outcome.	So, I am only myself around men I am not attracted to, and you know the outcome.
I hope you find a NICE girl.	I hope you find a nice girl.
ok i have liked this on girl since i was in ninth grade.	Alright, I have been attracted to this girl since I was in the Ninth grade.
To all my fellow girls at Cone, a big Hi and hug!	"To all of my fellow woman at Cone: a big ""Hi!"" and a hug!"
If shae like him then there is a reson .	If she's fond of him, a motivation exists.
If going to a movie is special for the 2 of you, then do that.	If attending the cinema is exceptional for you as a couple, take part in that activity.
It just sounds like u wear the pants.	It simply appears that you don the trousers.
have you told her that it's kind of irritating with her having to check up on you everyday?	Did you relay to her the annoying nature of her daily check-ins with you?
for the same reason thin girls prefer slender tonned guys	For that same reason that thin girls prefer boys who are slender and toned.
he handed me his cellphone and had me put in my phone number.	He handed his cellular phone to me and had me put my telephone number in it.
GO TO HAWAII...HA HA HA OR ....PAY SOMEONE...LOL	Go to Hawaii, or you could pay someone.
I don't understand why people think it's wrong.	I do not understand why people think that it is wrong.
Keep seaching for a believer in romance, she's out there!	Keep searching for someone who believes in romance, she is out there.
If you plan on cheating on your wife...you're a freaking pig and need to be shot!	You need to be shot if you plan to cheat on your wife.
Look, he already knows that you like him, and has he said anything bad about it?	Well, he already knows that you admire him.  Has he said anything about it?
CONFRONT HIM AND ASK HIM THAT WAY YOU WILL KNOW	Confront ask him, and that way you will know.
it's more of a trust issue i'd say.	I would say, that it is more of a trust issue.
Never stop trying to impress her .	Continuously attempt to impress her.
no , you are punish , and no tv for a month	Because you are punished, you get no television for a month.
LOL I think this is better than the one on top of me...	It is better than the one on top of me.
but that didnt bother me, because like i said wa&#92;e were just friends .	It did not matter as we are just friends.
Go to school you can still come home or call your family and friends.	You need to go to school. you can still come home or call you friends and family.
wow, go with the one that picks on you because 9 times out out 10 he likes you	The one that pick on you usually likes you.
I ALWAYS FELT THE SAME WAY, BUT I MET MY TRUE LOVE AND MY VIEWS CHANGED!	My views changed when I met my true love.
take baths ?know how to speak ?	Do you take baths? Do you know how to speak?
I like him and he says stuff like, if i weren't dating _ i would go out with you?	I like him and he says he would date me if I was single.
just get rid of him  you will be better off	Discard him, it would be better.
The One time in your life to really live out the true fantasy of love!	It's the only time in your life, you're able to live out true love!
People asked me - whats the hurry?	People had questioned me, why was I rushing?
Has he just dumped a girl and left before?	Has he discarded women with similarity before?
Needless to say, Im 36 now and STILL in therapy around it.	I'm thirty six currently. I'm still in therapy regarding it.
and for God sakes DO NOT be one of those controling baby mama's.	Do not be one of those controlling mothers.
Did you ever think of that?	Have you ever thought of that?
its been half a year- is it normal 2 still like him??	It has been six months, is it normal that I still like him?
look for a man that's hot!	Look for a man that is handsome.
It is realy sweet and just what u r looking for!	It is really sweet, just what you are looking for.
Is there a reason that your not w/the baby's dad?	Is there a reason why you are not with the babys father?
NO!NO!NO!IT CERTAINLY IS  MOST UNCOOL.U R SIMPLY WASTING UR HEALTH COS GIRLS JUST HATE IT.	You are wasting your health, because girls do not like that.
anything bigger than a handful is a waste, probably a size c or d	I prefr a size C or D. Anythign bigger is a waste.
I myself think that they do.	I think they do.
STOP trying to slap it in everyones face!!!	Do not be rude.
you should probably be looking in a public place where you are most comfortable.	You should most likely look for someone in a public place where you feel most comfortable.
...a guy asks me, 'do you mind if we cuddle?	One time a guy asked me if I minded if we cuddled.
or ask about the score of last game?	Did you ask about the score of the last game?
Because some couples NEVER get to that comfortable boring stage.	Some couples never get to the comfortable and boring stage.
I always say that you shouldn't do things if your gonna regret them later.	I always state that you should not do things if you are going to regret them later on.
Even the day after would be okay.	Even the following day would be alright.
well all ur missing is a million dollar smile..:)	Well, all you are missing is a smile worth a million dollars.
And I hear ya Fountain...same thing happened to me.	I hear you, Fountain, something similar happened to me.
altho, i dont really like girls all that much.	Although, I do not really like girls all that much.
Be really nice and give eye contact and smile a lot.. hope this helps!	Be really nice, give eye contact, and smile often. I hope this helps!
I would wonder why he shaved them but, in the end, they're his legs!	I wonder why he shaved them but in the end, they're his legs!
Best of Luck  to you both :)	Best of luck to both of you.
This is just what I have nurt many times.	This is just why I have been hurt many times.
i'll go with anything natural than fake i even hate the word fake	I prefer natural appearances, rather than a full face of makeup.
no 10 years younger, who wants an older women?	I prefer 10 years younger, who wants to be with an older woman?
Ask your best friend if it'd be okay.	Ask your friend if it will be okay with them.
Many people will tell you NO!	Many people will probably reject you.
Downtown Houston just about any weekend... Lots of clubs...	Downtown Houston about every weekend because of the clubs.
who said women dont feel anything?	Who said women do not feel anything?
And don't start with her looks, mister!	Do not start with her looks, Sir.
If they have moved on then you should too.	You also should move on if they have.
flirt and see how he reponds	Try flirting to see how he responds.
i am waiting till im married but when is it too far?	I am waiting until I am married, but when is it too far?
wit her takin ur number, there's nothing wrong wit that.	There is nothing wrong with her asking for your telephone number.
And you don't have to be an overly happy hyper-active person.	Also, you do not nee to be an overly happy, hyperactive person.
i dont wanna just randomly go up nd be like GO out wiht me?	"I do not want to just randomly walk up and say ""Will you go out with me?""."
Then comes the fun part...he making it up to you :-)	Then comes the fun part, him making it up to you.
you give at least 5 minutes for kissing and huging and may be some licking also .	Give at least 5 minutes for kissing and hugging and maybe some licking too.
i can't help any more unless i have more infor.	I can't help any more unless I have more information.
cause i say no on avatars	Because I say no on Avatars.
Some girls prefer gifts that won't die on them...something that lasts.	Some girls prefer gifts that won't die on them, something that lasts.
he is probably wondering if your interested in him at all....flirt back!!	He is likely wondering if you are interested in him at all; Flirt back with him.
I feel goofy, dorky, and happy.	I feel silly, nerdy, and happy.
if your a hoe then he's one to...i personally don't think your one tho	If you are a whore, then he is also one; I personally do not think that you are one though.
so there are some guys that only say the L word if they mean it.	"There are some men who only say the ""L word"" if they mean it."
I don't need a trophy girl I want a companion.	I do not need a trophy girl; I want a companion.
As a guy - let me say this.	As a man, I may have some insight.
BE CONFIDENT,ALWAYS BELIEVE IN YOURSELF.DO NOT BE ARROGANT THOUGH.ALWAYS MAKE GOOD EYE CONTACT.LISTEN TO WHAT SHE HAS TO SAY.	Believe in yourself, be confident, don't act arrogantly, and always listen to what she is saying.
Then he said do you want some of MY chapstick?	He asked if I would like to use his chapstick.
there isn't a wrong or right way to kiss anyone.	There isn't a proper way to kiss someone.
because we love them its not until later when we think about it that what we have done.	We do not think about things until later; and, this is because we love them.
I would not know... i have the same issue.	I do not know as I have the same issue.
what was the mistake that you did	What was the mistake that you took part in?
It's like breaking a drug habit.	It is like getting rid of a drug habit.
tell him, and it wouldn't seem psycho cuz u have kno each other for a long time	Speak to him, and it would not seem psychotic because you have known each other for some time.
hell yeah for the first answer.that girl answered for me.	Definitely for the first answer, that girl answered for me.
or, what about blue and green?	Or, what about the blue and green?
A life of your OWN....a life you've been missing out on.	A life of your own..a life that you have been missing out on.
Confusing... yeah, i think your right.	Confusing, yeah, I believe you are right.
Thing is, YOU DON'T HAVE TOO ASK HER OUT TO GO OUT WITH HER.	The deal is, you do not have to ask her to date to date her.
Maybe he's going to call you!	Perhaps he is going to telephone you!
OK, tell her, but be as polite as possible.	Tell her, but be as polite as possible.
in a park when i was 16 i lost my virgenate	I lost my virginity in a park when I was sixteen years old.
What guy doesn't like big boobs.	What guy does not like big breasts?
you should be proud of yourself.	You should be proud of yourself.
yeah ok men work and fix things but what else can you do?	Men work and fix things, but what else can you do?
we dont no what you look like !	We do not know what you look like!
IF YOU COULD HAVE 4 QUALITIES IN YOUR WOMAN, WHAT WOULD THEY BE.	If you could have four qualities in your woman, what would they be?
look in the internet u will find lots of things for the wedding or your local newspaper or news	Look online or check your local newspaper and you will find many things for the wedding.
if she sits on your bestfriends lap because she is drunk then yes it is a turn off.	If she sits on your best friend's lap because she is drunk, then yes that is a turn off.
See my boyfriend (go to my 360)?	Should I see my boyfriend?
u'll find a man who really deserves u one day).	You will find a man who really deserves you one day.
well, you, and that sexy perfume you wear!!	Well, you and that sexy perfume you wear.
If he isn't and you're still not ready, then screw him!	If he isn't and you are still not ready, then screw him!
why do they want it state sanctioned?	Why do they want it state sanctioned?
and she still lets me play with my trucks and watch cartoons!!!!!	She still lets me play with my trucks and watch cartoons!
Move on, but you can still luv him!!	You need to move on, but you can still love him.
see if he is willing to go out the way for you.	See if the guy you like is willing to go out of his way for you.
if anyone know let me know	If anyone knows the answer, please let me know.
I never knew life could be so good!!!!	I never knew that life could be so great!
and he said that he would call me back.	And he said he would call me back.
pick the one you like the most.	Choose the one you like the most.
take it off pop up block	Disable the pop-up blocker.
If you truely love him you will tell him	If you truely love him you will tell him.
who knows but i would absouletly love that 2 be done 2 me.	Who knows, but I would absolutely love for that to be done to me.
what shuld i do to get her ?	What should I do to have her?
Dude, you have to suck it up and introduce yourself.	Sir, you have to deal with it and introduce yourself.
there are movies that i haven't seen yet.	There are films that I have not seen yet.
i think it all depends on age, upbringing, .	I believe it is completely dependent upon age and upbringing.
And that will be just s*x!	And, that will be simply intercourse.
My boyfriend was definitely my friend first and it is total bliss!	My male paramour was sincerely my friend first, and it is complete bliss.
who gives a crap what anyone else thinks.	What does it matter what anyone else believes?
also try getting some blonde highlights	Also, try getting a few blonde highlights.
just let it all out, I use art a lot to vent problems that I have.	Let it all out. I use art to vent problems.
If she likes music, make a special cd or tape.	If she enjoys music, make a special CD or tape for her.
It could be  ( Choose one & why? )	It could be. Choose one and explain why?
Don't worry what people will say.	Do not worry what other people say.
I think a lot of girls like getting flowers.	It is my opinion that a lot of women enjoy receiving flowers.
i can't explain it...and no, it has nothing to do with them looking young, vulnerable or submissive.	I cannot explain it but it does not have anything to do with them being young, vulnerable, or submissive.
Let him go... either that or date his brother!	Either let him go or date his brother.
Yes there are you just have to look.	There absolutely are, you just have to look.
YOU CAN GET THEM IN STAPLES FOR $35	You can purchase them at Staples for $35.
Your Kid is going to have hard enough time growing up without a DAD.	Your child is going to have a difficult time growing up without a father.
My friend says I am to nice and I should tell them no.	My friend says I am too nice, and should tell them no.
My girlfriend always says she loves me when were passing notes during class, butshe doesnt say it confrontationally	My girlfriend always tells me that she loves me when we are passing notes during class, but not in a confrontational way.
That's right, the right relationship happened on it's own.	That is correct, the right relationship happened on its own.
You will look like an idiot.	You will look quite foolish.
no and u shouldnt care.if u like him then stay with him.	No, and you should not care. If you like him, then stay with him.
i thnk u shud b ur tru self, hav self esteem, self confidance	I think you should be yourself, have self-esteem, and self-confidence.
Anything that is not nailed down!	Anything that is not nailed down.
make it your top priority to see her if you really want to be with her that bad	Make it your top priority to see her, if you really want to be with her that badly.
one of my best friends had a thing with my big sister a few months ago.	One of my best friends had a crush on my big sister a few months ago.
Should I just forget it and move on?	Should I just let this go and move on?
There friends on the other hand, thats a different story...	Their friends, on the other hand, are a different story.
ummm yes i do i think anyone does!!	Yes, I do and I think anyone would.
my cuzin met up with some wierd old perv saying he was a hot teen that she met online	My cousin went online and met some strange older pervert who said he was a sexy teen.
none come in my list so i choose my neighbors wife :D	Help me choose my neighbor's wife!
I have long black hair and i love it,hubby loves it too.	I have long black hair, I love it, and so does my husband.
you care your family and everybody in your family will love you.	You care about your family, and your family cares for you.
Ugly (or fat) guys just take what they can get.	Ugly men just go for any woman available.
in the middle of the river while there was ppl watching it was actually pretty fuuny!!	In the middle of the river, there were lots of people watching!
its all in the eye contact	Eye contact is the key point.
Depends on the guy some guys do some don't	It is really a matter of what the man is attracted to.
it kind of gives us an idea that you may not have strong guts.	It gives us this feeling that you may not be strong enough.
i mean if u love him and he really loves u he may want to disapoint his father.	He may love you, but he also may want to disappoint his father.
Yes some men get right down to it with absolutly no thought for the woman.	Some men don't think of their partner when they just get to it.
maybe she's not a beeeatch and the skinny chick was	Maybe the skinny girl was a mean person and she wasn't.
it does sound a little girlie.	Doing that does sound rather feminine.
If you want to enjoy a bit - why don't you check out some restaurants, night clubs, gyms etc	If you want to enjoy your time, consider checking out some night clubs, restaurants, or gyms.
there are lost of good women left you just have to look in the right place.	There are many good women available.  You just have to look in the right places.
Hey, its like, everyone's gotta seperate some day or the other.	Everyone has to break up at some point.
you win some you lose some take it with a grain of salt and be more carefull next time	You win some and you lose some. Take it with a grain of salt and be more careful next time.
happy birth day to you .	Happy Birthday to you.
i just need someone to help me figer this out	I just need someone to help me figure this out.
pick the 1 w/ better treatment towards u	Pick the one that treats you better.
i'm into a 6th grade boy too!	I like a sixth grade boy too!
if you end it he might not be your friend thats why i dont go with friends	If you end it, he may not be your companion, that is why I do not enter romantic relatinos with companions.
stick yourself out there more, you have to do far more than eye contact	Attempt to emphaszie yourself more often, but you have to do far more than simple eye contact.
do whats best for you and he	Do what is best for you and him.
bad teeth , bad breath and bad bo.	Poor teeth, horrible breath, and deplorable body odor.
no one needs to know that!	Nobody needs to know that!
if i am to ask, i'll then leave, stop the relationship and move on with my life.	If I have to ask then I will leave and end the relationship and move on with my life.
Hey, do not get me wrong.	Do not misunderstand me.
I asked him if he still liked me and he said yes but he didn't act like it.	I asked if he still liked me and he said he did but did not act that way.
Where am I going with this?	Where am I going with this?
keep getting her younger and younger guys as one gets old get a new one for her...	Keep getting a younger and younger woman, men. As your woman gets older, get a new one.
You know that's if u didn't play the guilt trip.	You know that is if you do not play the guilt trip.
That doesn't mean it makes it right, it means that it makes us human.	That does not mean that it is the right thing to do; it only makes us human.
It is a mistake that can't be undone!	This is a mistake that cannot be undone!
practice unwrapping starburst with ur tongue, and tieing cherry stems w/ your tongue.	Practice unwrapping Starburst with your tongue, and then tying cherry stems with your tongue.
You catch her looking at you?	Did you catch her looking at you?
I know 3 guys that I can probably get away with doing something like that.	I know three men with whom I could probably get away with doing that.
ask her out or tell her u like or admire her.	You should ask her out or tell you that you like or admire her.
if he's gonna be an on and off guy like that i say dump him 4 good!	If he is going to be an on and off partner, then I suggest that you break off ties for good.
If they dont then you'll have to get on with your life.	If they do not, then you will have to continue with your life.
i have never been to it	I have never attended it.
complement her...ask her name...dont act weird...act like u r the smoothest guy ever.	Compliment her and ask for her name. Do not behave strangely. Act as though you are the most suave man in existence.
she calls him all the time.	She calls him often.
is How should I approach her and be not just another guy hitting on her?	How should I approach her so she does not think I am another guy hitting on her?
wait a little while then date guys that way you enjoy it more.	If you wait a little while before dating guys, you might enjoy it more.
Someone who's never 'bitchy' just because she thinks it's cool...it ain't.	It is not cool to act better then someone else.
b/c you dont have any decision power what to do	You do not have to make a decision about what to do.
I know... Why should I hide it?	Why should I hide it?
Some guys just don't like to dance.	Some men do not like to dance.
Truly she isn't ur friend, b-cuzz she won't stop bugging u!	Truly, she is not your friend, because she will not stop annoying you.
i wish i had listened to my friends	I wish I had listened to my friends.
After how much time can you conclude that it takes too long and she isn't really interested?	After how much time you can conclude that it takes too long, and she is not really interested?
do i want to be in love?	Do I want to be in love?
Why do they want to be MARRIED???	Why do they want to be married?
No brainer  Oh and nice picture of George Clooney on your profile LMAO	That is a no-brainer, and nice picture of George Clooney on your profile.
Some woman cannot seem to find guys their own age attractive.	Some women cannot seem to find men their own age attractive.
some do, but i would rather have a pair that were not too big	Some do, but I would rather have a pair that was not too big.
It sounds like you are both comfortable with things just the way they are.	It sounds like both of you are comfortable with the ways things are.
so so sexy YES it look very nice on most any girl	Yes, it looks extremely beautiful on almost any woman.
sometimes its better to be very good friends first and make sure ur happy around each other	Sometimes it is better to be very good friends first to make sure that you will be happy around each other.
Anyway my question is.... Will I always feel that way?	"My question is, ""Will I always feel that way?"""
Listen to Faith Hill - Love Ain't like that            its a great example	"A tremendous example would be Faith Hill's, ""Love Ain't Like That."""
child please, dont ask that question if you dont want your feelings hurt	Don't ask that question, if you don't want your feelings to be hurt.
And the gf should accept that about if she loves you.	She should be accepting of all your many facets if she loves you.
I think it's totally hot when a guy shaves his legs.	I think it is really attractive when a man shaves his legs.
If u guys still keep in touch---I dont think thats the best thing to do.	If you two still keep in touch, I think you should maybe cease contact.
i like this boy austin and i told my friend claudia to ask hin if he likes me	I like Austin and asked my friend Claudia to see if he likes me.
YOU ARE KILLING THE ROMANCE BY POPPING UP THAT STUPID QUESTION, ever thought of having fun together instead?	You are hurting the romance by asking that question.  You should just focus on having fun together.
He's a player...no good trust me...	Trust me, he is a player and no good.
it depends they all like different 1's but not selfsenterd freaks like u	It depends on the person.  They like different kinds of people, but not those who are self-centered, like you are.
i think thats fantastic, maybe you should do the first move!	That is fantastic news!  Maybe you should act in the first movie.
IF he tUrNS YoU dOwN, HES NOT WORTH IT IN THE FIRST PLACE!!!!	Should he refuse your request, his value is too low to begin with.
well just go up to her.	Well, simply approach her.
It's a good idea to always be honest...besides not many guys I know don't like being told they're hot!	It's a beneficial notion to consistently practice honesty...not to mention, the majority of men I'm familiar with don't mind being referred to as attractive.
They know the women will not chase them like good looking or wealthy men who get tons of chicks.	They're aware the females will not pursue them like they will attractive or moneyed men who land a slew of women.
Just face him, say Hey I like you wanna see a movie?	Just face him and ask whether he would like to see a film.
thats why they call it making love.	That is why it is called making love.
Smile to him once in a while...then he will know...	He will know if you smile at him once in a while.
most girls are polite she'll answer it	Most girls are polite, and if she is, she will answer it.
i would... you sound alot like my best friend.	I would because you resemble a close friend of mine.
Say hey(whateverhisnameis) when ya taking me to dinner???	Hello, when shall we have dinner together?
it really depends on the guy but i think most guys seriously don't care.	I think most men do not care, but it does depend on the individual person.
if you want it to work out it will .	It will work out if you want it to.
If he doesn't want to dance, then give it up.	Give up if he does not want to dance.
But you know what, I feel the guy should make the first move.	I believe that the man should take the first initiative in a relationship.
without having a boyfriend would be a bit slutty.	If you do not have a boyfriend it would make you seem easy.
WAIT take it from a military girl WAIT!!	Take advice from a military girl and wait.
you never know gurl they never show efection only when they want somthing	You can never tell, they never show affection unless there is something that they want.
i am 49 yrs of age and looking for a beautiful woman to spend my time with and possibly?????	I am forty-nine years of age and am looking for a beautiful woman to spend my time with and possibly more.
do you mean seem more sexy?	Do you mean to seem more sexy?
go to deleted items and it should be there	Go to 'deleted items', it should be there.
THIS IS A RED FLAG OF HOW THIS GUY IS.I WONDER!	I wonder if this is a red flag of who this man truly is.
may be becaues your name is freakgirl but if you show your face maybe not no hard feelings	Perhaps because your name is Freakgirl.  If you show your face, then maybe not.  No hard feelings.
that would be sooo painful you know,trust me been there done that!	I have been there and done that.  Trust me, that is going to be extremely painful.
Do U love her in depth?	Do you love her deeply?
Have fun in jail asking that question to your cell mate.	You can ask that question to your cell mate.
;) nah the only time u see a man emotional is when he is with his lady luv!	You can only see a man get emotional when he is with his lady love.
yes i have done it it was a lot of fun.	I have done it, and it was a lot of fun.
Gotta let the person you are with know what u want.	You have to let the person know who you are and what you want.
Ofcourse, if she calls like 5 times a day about that, then it would be crazy.	I would be crazy if she called me 5 times a day.
HANG IN THERE FOR ONE THAT APPRECAITES YOU.	Hang on there for one that appreciates you.
my mom books them all of the time pat@alanatvl.com	My mom books them all of the time through the email:pat@alanatvl.com
besides don't you think he has enough to worry about?	Besides don't you think he has enough to worry about?
ive been dating this guy that's younger than me.	I have been in a relationship with a man who is younger than me.
Men play at love to get sex, women play at sex to get love.	Men pretend to love in order to have intercourse; women pretend to enjoy intercourse in order to get love.
it's got to get played out after a while.	It must become annoying after a time.
Everybody likes to be told that they're hot, even if they don't admit it!	Everybody enjoys being called attractive, even if they will not admit it.
yes but it dipends of the guy	Yes, but it depends on the man.
Mabey because ou just think they look sexy when they are running on the feild	Perhaps because you simply think they are sexually attractive when they run on the field.
Your too young to be talking about kissing already.	You are too young to be speaking of kissing already.
i prob will tell her soon cuz shes my best friend ha well any help would be nice.	I will most likely inform her soon because she is my best friend. In any case, any help would be appreciated.
i agree with the other preson before anyone gets hurt	I agree with the other person before anyone comes to harm.
I'm ready to move on, but I love him way too much!	I am ready to move on but I love him to much to do so.
Go out & do EVERYTHING you couldn't when you were with him/her!	Go out and do all of the things that you could not when you were with him or her.
Obviously, men ain't much better ;-)	It is apparent that men are not much better.
What if you tell him that you just want to be friends with benefits.	Perhaps you could inform him that you simply want to be friends with benefits.
play a truth or dare game together	"Try playing, ""Truth or Dare,"" together."
he sounds like a manipulative jerk.	He sounds like he is a manipulative simpleton.
slow down the pace maybe, fourplay,	You should try foreplay, it slows down the pace.
Death is like a big black bag full of of crack or smack or meth.	Death is similar to a large black bag, full of drugs.
PRACTICE KISSING ME  WERE DO YOU LIVE?	Where do you live?  I could come over and you could practice kissing me.
no you wont huni......i was married to a complete arsehole!!!!	No, you won't get hurt.  I was married to a complete jerk!
sounds like you really love her...no need to forget her!	It sounds like you really love her, so there is no need to forget her.
tell him that u jst wannabe friends and that u r relly disappointed that he would act so dumb!!!	Tell him that you want to be friends, and that you are very disappointed that he would act the way he did.
It always finds a way to get out in the open, just don't do it!	Don't do things you do not want others to know about.  Things always end up becoming public.
and yuck, what is with chest hair?	And why does chest hair exist?
as for now i think he is mad, hurt, upset and got over you.	As for now, I believe he is angry, hurt, upset, and no longer interested in you.
Give your brother some money and tell him to take a hike!!	Give your brother some money and tell him to leave.
no offense, but it kinda sounds like a girls name ya know but no disrespect intended!	No offense, but it sounds like a woman's name, but I mean no disrespect.
be cool and ask her on a date!	Ask her on a date.
well after u take her out get to know her some and then go 4 the kill,ask her out	Take her out and get to know her, and the nask her out.
People don't like to be played yo-yo with.	People do not like their emotions played with.
practice to unrap starburst wrappers with your tounge, the girls love it!	Practice by unwrapping starburst wrappers with your tongue.
I don't know!...I just want the points...lol	I only want points.
that's not exactly true.... it's just that most girls are discreet about it...	That is not entirely true. It is simply that most girls are discreet about it.
THAT DEPENDS...ARE YOU A HOTTIE W/A BODY?	That is dependent on whether you are physically attractive.
I told him it was too late...other than that, I wouldn't have minded getting flowers sometimes.	I informed him that it was too late. Other than that, I would not mind receiving flowers at times.
believe in is a strange way to put it.	"""Believe in"" is a strange way to phrase it."
Why can't men (or boys in your case) ever say the word LOVE?	"Why can men (or boys in your case) not ever say the word ""love""?"
Just enjoy the age you are and don't worry about all this.	Enjoy the age you are now, and do not worry about this.
though i'm 19, i like anything up to 30?	I am 19, and I like anyone up to 30.
i had a friend in the same situation.	I had a friend in the same situation.
girls are just as perverted--trust me.	Females are as dirty minded, trust me.
You shouldn't go out with a guy because you 'need' to.	"You should not go out with a man because you ""need"" to."
Dude, what your sayin is she doesn't want to be more than bf and gf?	So what you are saying is that she does not want to be more than boyfriend and girlfriend?
IS IT USUALLY ABOUT A YEAR BEFORE BOTH PEOPLE BEGIN 2 FEEL IN THAT COMFORTABLE,BORING, STAGE??	Is it usually about a year, before both people begin to feel that comfortable, commonplace stage?
Probably because I knew all the girlfriends were not really the one until I met my wife.	"Probably, because I knew that all of my girlfriends were not truly, ""The One,"" until I met my wife."
i think as long as you dont base your relationship on sex its ok	In my opinion, as long as you do not base your relationship on lovemaking, then it is okay.
But some guys would do that...   WHY?	Why would some men do that?
if your the average guy breast size shouldn't matter.	If you are the real man, then breast size should not matter.
Stay far far away from guys who can't say I LIKE YOU.	Avoid men who can't be open about their feelings.
yea ask for permission by all means and watch how fast she slap the s--- out you	Ask for permission, and watch how fast she rejects you.
Honey my husband likes me for me.	My husband likes my personality.
my mom also has cancer and this just hits to close to home for me.	My mother has cancer as well, this is too personal for me.
then be your best self, if he's impressed or likes you he'll talk back	Be your best self, if he is impressed or likes you, then he will talk back.
you dont want anyone else but that person ever	You do not ever want anyone else but that person.
why don't you try chatting/seeing other guys just to catch his reaction?	Why do you not try talking to and even seeing other men, just to see his reaction.
BUT IT IS OKAY TO KISS ON THE FIRST DATE.	It is okay to kiss on the first date.
guys have a problem with secrets.	Men have an issue with secrets.
I had someone get nasty with me because I was still dating?	I had someone get quite rude with me because I was still seeing people?
So how do i just kiss him	So, how do I just kiss him?
I am the maid of honor for my only sister and I want it to be perfect!	I am the Maid of Honor for my only sister and I desire for it to be perfect!
unless it's with the wrong man.	Unless it is with the inappropriate man.
