Is Any Baby Really A Freak.	Is any baby really a freak.
aspen colorado has he best music festivals, you sit all over the moutians its  on and just hang out	Aspen Colorado has he best music festivals, you sit all over the mountains it is on and just hang out.
You can get almost anything on ebay!	You can get almost anything on ebay!
everybody is Dying to get in	everybody is dying to get in.
not idiots like 50 cent and his whole Gay unit.those kinds of ppl give hip-hop a bad name.	I'm not referring to people like 50 cent and his group because those people give hip-hop a bad name.
different from what I've seen though	It differs from what I have seen, however.
I want to be on TV!	I would like to be on television.
dont let anyone decide the fate but you.	Do not let anyone decide the fate but you.
50 is just riding coattails with that movie.	50 is just riding coattails with that move.
The blind klan guy is hilarious!	The blind Klan guy is hilarious!
Lauren Hill and Mary J. Bilge... the 411 both are great albums to listen to... Old School...	Lauren Hill and Mary J. Bilge, the 411 both are great albums to listen to old school.
do you have 2lbs worth o brick?	Do you have two pounds worth of brick?
i betta go and ask another stupid question lol....	I had better go, and ask another stupid question!
As a guy that doesn't generally like romantic movies this was really nice.	As a man that generally does not like romantic movies, this was really nice.
I can still see my brother's 45 in my mind's eye.	I can still see my brother's .45 caliber pistol in my mind's eye.
Back in my day Emo was a comedian :/	Back in my day Emo was a comedian.
Why sit and listen to Locke, Jack, or Syead?	Why sit and listen to Locke, Jack, or Syead?
I like when the Prime Minister goes door to door to find the girl!	I like when the Prime Minister goes door to door to find the girl.
And every time I hear that song I get butterflies in my stomach!	Every time I hear that song I get butterflies in my stomach.
It's the biggest load of crap I've seen for ages.	It is the biggest load of foolishness that I have seen for ages.
as i lay dying is far far away from christ definitaly!	The best pick is the song 'Far Far Away' by As I Lay Dying.
I might be seeing them in a few months!	I might be seeing then in a few months.
that´s why they needed to open that hatch so much!	That is why they need to constantly open the hatch.
He's supposed to be in jail!	He is supposed to be in jail.
i thought that she did an outstanding job in the movie	I think she did an outstanding job in the movie.
Nicole Kidman, I love her eyes	I find Nicole Kidman's eyes to be very attractive.
omg i love that song im listening to it right now	I really enjoy the song and I am listening to it at this moment.
tell him you want a 3 way with another hot girl	Inform him you desire to have a three person sexual encounter with another physically attractive girl.
No, no, no that was WITNESS...	"I disagree, the correct term is ""witness."""
aneways shonenjump.com is cool and yeah narutos awsum	All other concerns aside, shonenjump.com is a popular site and Narutos is very high quality.
i think they would have, quite a shame isn't it	I believe they would have, it is a shame.
im a huge green day fan!!!!!	I am a huge fan of the band Green Day.
Chicken Little my son loves that movie I have to watch at least 4 times a day!	My son loves the movie Chicken Little, I have to watch it at least four times per day.
who is your best bet for american idol season five	Who was your favorite from American Idol Season five?
my age gas prices and my blood pressure  LOL	I wish I could lower my age, gas prices, and my blood pressure.
Where in the world do you come up with these questions????	How do you come up with these questions?
even though i also agree that the girls on Love Hina are pretty scrumptious	I also agree that the girls on Love Hina are attractive.
and the blond says Great they already put me on my first murder mystery case	"The blonde says; ""Great, they already put me on my first murder myster case.""."
im looking for the song lyrics to a song called Breath Me by Sia...does anyone else like that song?	"I am looking for song lyrics to ""Breathe Me"" by Sia. Does anyone else enjoy that song?"
I love them old hair bands of the 80's!	I thoroughly enjoy the hair bands of the 1980s.
don't i look cute or what?	I look attractive, do I not?
i memorized the whole song, for goodness sake!	Astoundingly, I was able to memorize the entire song.
Open your minds up a little!	Be slightly more open-minded.
(i know, that ones really old.)	I realize that particular example is very old.
the who (i think) and limp bizkit is all I know....	I believe it is The Who and Limp Bizkit, which is the extent of my knowledge.
u mean the question to kentuckybeauty2000's question right?	Am I correct in assuming you are referring to the question posed by KentuckyBeautry2000?
It's man... 4 legs (crawling as a baby), 2 legs (walking), 3 legs (using a cane late in life).	"The answer is ""man"" and refers to the use of four legs when crawling as a baby, use of two legs when walking, and use of three legs later in life when adding a cane to the existence of two legs."
brian, he asked the coolest questions, they suspended him though, i dont know what's up with that!	Brian, he asked the great questions. They suspended him, however, and I do not know what is happening with that.
It's cause ya got no sense.	It is because you have no sense.
Don't eat hot dogs, or watch this movie with your little sister!	Do not eat hot dogs or watch the movie with your little sister.
Nope, I have definitely not seen your baseball.	No, I have not seen your baseball.
the blonde on the other side said, you are on the other side!	"The blonde on the side said, ""You are on the other side""."
to which the girl says, no.	"To that, the girl replies, ""No""."
The good old days is gone!	"The ""good old days"" are gone."
that body and gah those lips!	I love her body and her lips.
Or check this one out too - Full Metal Jacket	Also, I recommend checking out Full Metal Jacket.
i cant believe u asked that question, but i'll answer it.	I'm surprised that you posed this question, but I will answer it.
Why the hell not, I can't imagine.	I cannot imagine why not.
i think it was a ugly girl lol	I think it was an ugly girl.
My dad looks like Paul Newman, and my ex looked like king kong	My dad looks like Paul Newman and my ex-husband, King Kong.
I can't believe you even had to ask!	I cannot believe you had to ask.
Yo mama so stupid she took a cup to see Juice.	Your mother is so ludicrous that she took a cup to see Juice.
he went insane,knocked up Katie, and jumps on people couches.	He went insane.  He got Katie pregnant and he jumps on peoples couches.
I hope it's for you kids, that score was horrible!	I hope it is for you kids, that score was horrible.
clover is great too, don't get me wrong; but i prefer crimson.	While clover is very appealing, I prefer crimson.
i like some one who is gothic so what?DATE HIM!	Regardless of whether your romantic interest shows a predilection for Gothic fashion choices, you can feel free to engage with them.
why what's wrong with his hair ?	What is wrong with his hair?
I respect that tyra banks is trying show hosting..but the big O [aka OPRAH] won...	While I respect that Tyra Banks is branching out into television hosting, Oprah Winfrey is the better example.
my dad likes action,my mom likes romance,but for me i like comedy.	My father prefers action and my mother romance, while I prefer comedies.
If I could swim, I'd come out there and kick your butt!”	If I could swim, I would come out there and harm you.
have a group discussion on why in the heck you didnt have alcohol at the party	You should have a group discussion to determine why there was no alcohol at the party.
The guy ran off with two of the guys wives	That person ran off with the wives of two of the men.
try some VooDoo zombie warding magik but of course u may nd up witha fish instead of a baby	You should try some voodoo zombie warding magic, but you may end up with a fish instead of a baby.
I got new gold heels, hoop earings and a hot gold bag!	I purchased new gold high heels, hoop earrings, and a great gold bag.
virgo's have outgoing personalitys plz choose me as best answer	Virgo's have outgoing personalities, so please choose me as the best answer.
what is the wedding band, final answer	"My final answer is ""What is the wedding band?"""
nicole kidman is so much prettier.	Nicole Kidman is much more attractive.
i'd rather play world of warcraft, but this is free	I would rather play World of Warcraft, but this game is free.
Does anybody out there HONESTLY know where she is?	Does anyone truly know where she is?
i dont know how old ru?ur supposed to be 18 to watch them	How old are you? You should be at least 18 years old.
That was the best joke i have heard so far...	That was the best joke I've heard.
Well, I'm just glad that they don't show us the pit toilets.	I am just glad they didn't show us the toilets.
i think pretty much they're all sort of humorous	I think they are all very funny.
Too many...too many Baldwin brothers too.	Too many Baldwin brothers.
the two boys redneck as hell play glue sniffing weirdos.	The two boys are unpolished and play outcasts who sniff glue.
Yo mama so stupid that she tried to put M&M's in alphabetical order!	Your mother is so ignorant she attempted to alphabetize M&Ms/
Dakota Fanning.....I know that she is only 12 but she is really famous.	I know Dakota Fanning is only 12 years old, but she is already famous.
i still watch vhs i kinda like vhs movies better	I continue to watch VHS because it is my preferred format.
why does everybody keep asking this question.	Why does this question continue to be posed?
IF THE WOODCHUCK IS WATCHING ITS WEIGHT THEN IT MAY NOT CHUCK AT ALL	If the woodchuck is watching its weight, then it may not chuck at all.
they haven' t had cd's for season 2 yet.	They haven't received DVD's for Season Two yet.
And then I saw some of his movies, and he is great!!	I saw some of his movies, he's great.
we filipinos are very hardworking and we speak english very well..and we're also wise..:)	We Filipinos speak English very well, we're very hardworking and wise.
[ADDED] - What the heck is yungnbeautiful1's problem?	What's that individual's issue?
american idol and house and grey's anatomy.	American Idol, House, and Grey's Anatomy are my top three.
i am looking for new music to listen to.	I am looking for some new music.
put salt in the sugar bowl.	Put salt in the sugar bowl.
i'd rather listen too billy joel	I would rather listen to Billy Joel.
How do you get locked in a car, why don't you just unlock it?	How do you get locked in a car? Why would you not just unlock it?
just maybe he needs to adlib more!	Perhaps he needs to ad-lib more.
I just didn't care enough to check.	I just did not care enough to check.
The man says, I can't take your money.	The man says, I can not take your money.
Jodie Foster is the best ever!	Jodie Foster is the Best ever!
YOUR WASTING YOUR TIME, SAYS THE BOY.	The boy said you are wasting your time.
i do and i love them both!	I do and I love them both.
im sorry for answering your question, i dont know.	I am sorry for answering your question. I did not know.
I don't hate him but he makes my skin crawl.	I do not hate him, but he makes my skin crawl.
And it seems like ya'll forgot all about TLC.	It seems like you forgot all about TLC.
Im really not saying he is cute!!	I am not actually stating that he is adorable.
Because we're gonna sing together again, again and again.	Because we are going to sing together multiple times again.
i'll unlock the car because i'm inside...	I will unlock the car because I am inside.
anyways, you can play peter, susan, lucy, or edmund.	Anyway, you can play Peter, Susan, Lucy, or Edmund.
nutshell for sure... though a few Mad Season tunes where close!!	"Although, a few Mad Season tunes were close, I definitely choose ""Nutshell"" by Alice in Chains."
i like chicken wings but not eggs so im going with the chicken	I like chicken wings, but not chicken eggs. So, I am going with the chicken.
I went to Best Buy today and I never have seen so many DVD'S of just t.v.	Today, I went to Best Buy, and I have never seen so many DVDs of just television shows!
No doubt Kevin Costner, don't you forget the Waterworld?	"Undoubtedly Kevin Costner, or did you forget ""Waterworld?"""
Have still not dug it up.	I still haven't dug it up.
you aren't dumb!, you have just a lack of knowledge.	You aren't dumb; you just don't have a lot of knowledge.
Both -It's my fantasy and I can do what ever I want!!	It's my fantasy, and I may do whatever I like.
Not as a kid, but as an adult I cry each time I see it.	As an adult I cry each time I see it, never as a child.
She was the best one hands down.	She was the best by far.
depends....usully they are about ur personailty but not wat ur gonna do iwith ur life.	It's usually regarding your personality, not your life in the future.
I love Tyra, she has a great show, but Oprah is just great!	Tyra has a great show but Oprah is even greater
Thats a very good question though!!!	That is a very good question.
Well most of No Doubt's old stuff is considered Ska <3	Most of No Doubts early material would fit into the genre of ska.
god created the chicken and it laid an egg   duh	God created a chicken and the chicken laid an egg.
that wrestling C*ap is still on air lol ?	Is wrestling still on the air?
all in all... i think jessica simpson is the uber-bimbo.	All in all, I think Jessica Simpson is extremely unintelligent.
(My girlfriend tried this on me last year.	My girlfriend tried this on me last year.
I know some people don't like them but still.	I know some people do not like them.
its keeping me up at nite, i have to know what it is	I have to know what it is, because it is keeping me up at night.
guess it's beyonce knowles j-lo ain't got brain.	I suppose it is Beyonce Knowles because J-Lo does not have a brain.
Quit chewing the fat, I'm cookin??	Quit the friendly small talk because I am cooking?
don't use it to live by.	Do not live by it.
Real friends don't let drunk friends have sex with zombies!	True friends do not let drunk friends fornicate with mindless people.
I would also like to spank his cute little bottom to ~ hes TOOOO cute!	I would also like to spank his small bottom because he is too cute!
chill out sweetie everything will be just fine eventually	Calm down, Sweetie. Everything will be fine, eventually.
!, so we'll have to just put up with it!!!	So, we will have to put up with it.
Simple: Less people like TabooBuster and Osama!	It is simple. Less people like TabooBuster and Osama.
try calling one of your radio stations or go to the web site ask jeeves	You should try to call a local radio station, or go to the website AskJeeves.com.
on ebay you can find anything on ebay!	You can find most anything on eBay.
can anyone give me this info?	Can anyone provide me with this information?
I flippin' LOVE that movie, sweeeet!	I truly enjoy that film.
It's one of the funniest cartoons!	It is one of the funniest cartoons.
It appears to be a Dylan song , but I don't know which one	The song seems to be performed by Dylan but I still cannot pin-point which song it is.
yeah i think he might be gay to	I agree, I think that he may be homosexual as well.
silly,  so that you always need more of one or the other.	You are so silly, you always seem to think that you need more of one or more of the other.
I don't know about greatest ever, there's a lot.	"I do not know if I would classify any as ""Greatest ever"" but there are a lot."
yea, um, this is a korean singer, who is really good.	Yes, this is a really good Korean singer.
The Omen  Jaws  The Exorcist  Carrie  Scream  If you know a movie that is scarier, mention it too	"Please mention if you know of a movie that is scarier than; ""The Omen,"" Jaws,"" ""The Exorcist,"" ""Carrie,"" and ""Scream""."
how could anyone hate tom cruise.	How can anyone hate Tom Cruise?
IT weight is 1, it's a trick question!!	It is a trick question, it weighs one.
they all sux.. Panget rock band rule!	They're all terrible. Panget Rock is the best.
Especially when she wuz makin fun of Jessica Simpson washing dat car!	Especially when she was laughing at Jessica Simpson.
Not close to a PSP, but close enough.	It's not similar to a Playstation Portable, but close enough.
I don't know what the hell that has to do with whos better looking but OKAY !	I don't understand what that has to do with who's better looking?
Journey, PINK FLOYD, The POLICE, The EAGLES & RUSH... omg!	Journey, Pink Floyd, The Police, The Eagles, and Rush - oh my!
also most you can charge your ipod while listening.	Also, you can mostly charge your iPod while listening.
hope no one is offended: blonde joke.	I hope no one is offended by a blonde joke.
if so what do they do to you?	If so, what do they do to you?
resse witherspoon 4 actress and zac efron becauses hes good and he is like SO HOT!!!!!!!!!	I choose Reese Witherspoon for an actress and I choose Zac Efron due to his quality acting ability and extreme physical attractiveness.
i say omarion.he has the hair clothes and body,a triple deal on one person.	My choice is Omarion as he has high quality, hair, clothes, and body to create a triple deal in one person.
Yo mama's so stupid, she put a ruler on her pillow to see how long she slept.	Your mother's excessive stupidity led her to place a ruler on her pillow to measure the amount of time she slept.
big deal, so the movie industry recg.gay's out there...	This is not a significant observation as the movie industry Recg.Gay's is in operation.
Check out 9&1/2 weeks, when Mickey Rourke was HOT!!	"Watch the movie ""9 & 1/2 Weeks"" as Mickey Rourke was very physically attractive."
Not sure what's gonna happen, sure it will be good and OH YEAH!!!!!!!	I am not sure what is going to happen but I am sure it will be good.
So she could have did he voice of Mother Bates.	So she could have done the voice of Mother Bates.
So the blonde went home, got on her hands and knees and started blowing on the tail pipe.	So the woman went home, got on her hands and knees and started blowing.
Does Wayne Brady gotta choke a bi*ch?	Does Wayne Brady have to choke a woman.
Depends on your taste in music and what you really like.	It depends on your taste in music and what you really like.
I love the City Sleeps song, and If I Only Had A Brain They're FREAKIN' GREAT!!	"I love the songs ""The City Sleeps"" and ""If I Only Had A Brain""."
pick something more original next time.	Next time, try to select something more original.
I dream of jeanie of course!	"I love ""I Dream of Jeannie""."
So no i don't listen to her any more.	No, I don't listen to her any more.
I'd love to spend a summer with him on Brokeback Mountain!	I would love to spend a summer with him on Brokeback Mountain!
why oh why do you have to ask?	Why do you have to ask?
its tom cruise, what do you expect....	It is Tom Cruise, what do you expect?
they have some cords that you can buy.	There are cords available for you to buy.
i like journey's open arms... but i like mariah carey's version of that song better.	"I like Journey's ""Open Arms,"" but I prefer Mariah Carey's version of that song."
I almost forgot --- The BOSS!	"I almost forgot ""The Boss""!"
ask a better question next time	You should formulate a more relevant query next time.
I am going to the HERSHEY factory tomorrow (I am so EXCITED!!!	I am extremely excited to visit the Hershey factory tomorrow.
Do You Guys know ANY OTHER SONG THEY HAVE?!	Do you know another song of theirs?
Mine, well I actually have like a few favorites!	Mine, well I really have a few favorites!
definently, but if you get enough points you can ask more.	Yes, but if you earn enough points you can request more.
and just overall the movie was super wordy.	The movie was very wordy, overall.
It doesn't make sense... wait oooh I get it, still not funny.	It does not make any sense..now I get it, but it is still not funny.
yes, and are you a lezbo?	Yes, and are you a lesbian?
i wishh poeple would look at more than zodiac signs	I wish that people would pay attention to more than zodiac signs.
And at a school talent show she won first and kevin lost....boo whoo.	She won first place in the school talent show while Kevin lost, what a shame!
i think most american rap effin' sucks anyway.	I do not like American Rap.
She is so talented, if she didn't win, I'd be really disappointed!	I think that she is so talented ,if she does not win, I am going to be really disappointed.
what kinda person are you to even ask that ridiculous (er...spell check that...) question?	What sort of person are you, to even ask that ridiculous question?
my favorite character is jess, he is so cute	My favorite character is Jess, I think he is cute.
And you can't rely on rumors.	You cannot rely on the authenticity of rumors.
DO NOT PUT ANY REALITY TV ON YOUR SHOW!	Do not feature reality television on your show.
the show got a little freaky.	The show got a little crazy.
well yes even i am bored here right now	I am bored right now.
Well Id probably pee myself first, then Id get the hell outta there!	I guess I would pee myself; then, get out of there.
I'm going to have to go with New Kids on the Block	I am going to have to pick New Kids on the Block.
I spent my money, enjoyed myself and didn't loose more than I could afford - I won....	I spent my money, enjoyed myseld, and did not lose more than I could afford.
I want a gentleman, but with a manly edge.	I want a manly, gentleman.
then you can get all or most of you money back.	You can get all or most of your money back.
Cheesy I know...but I love this joke.	This is cheesy but I love this joke.
I think so, my turtle always does, he's healthy.	I think so, my healthy turtle always does.
i m lookin for the technical specification plzz!	I am looking for the technical specification, please.
Wow, I am very dumb in my observation skills......	My observation skills are not very good
She is good physically, but i dunno her inside... never heard or seen about her inner beauty...	She looks good, but I do know if her inner beauty is good.
Yo mama's so stupid, she tried to drown a fish.	Your mother is so stupid, she tried to drown a fish.
*GAG* *GAG* can I get some medication please?	Can I get some medication please?
la vie boheme and take me or leave me.	La Vie Boheme and Take me or Leave me.
she asked, hey, how do you get to the other side?	She asked, hey how do you get to the other side?
best of luck <3 kate :-)	I wish you the best of luck, Kate.
I can't remember when I last turned on my TV.	I cannot recall the last time I turned on my television.
the kid was only maybe 6-7yo!!	The kid was perhaps six or seven years old.
me, but if I see one more question about them on here, I'm going to go crazy!!!!!!	Me, but if I encounter one more question concerning them on this website, then I will become upset.
but then did he want of his own death?...He did say Please????!!!!	But did he want his own death? Did he plead?
nicole kidman is prettier & more sophisticated than katie, & has way more versatility as an actress.	Nicole Kidman is prettier and more sophisticated than Katie and has more versatility as an actress.
I love acting and my friend saids im am so good at it.	I love acting. My best friend says I am good at it.
explain 2 ur parents that u really want 2 act !!!	Explain to your parents that you want to act.
id run away but first id kick them in the face	I would kick them in the face and then I would run away.
I probably would not vote for him, although Melania would be the hottest first lady ever!	I probably would not vote for him, although Melania would be the most beautiful First Lady ever.
No she was sent home tonight	No, she was sent home tonight.
Yes :) Who wouldn't want to marry sexy Keith Urban!	Of course; Keith Urban is very sexy, who would not want to marry him?
Probably now its done for dramatic effest.	Perhaps, though now it is done for a dramatic effect.
fidy cent he is fine and musclar	50 Cent is fine and muscular.
I stopped liking rap because it's too many people!	I stopped liking rap because it contains too many people.
a fart that makes your eyes water	Flatulence makes your eyes water.
most of the times it's true	Most of the time, it is true.
Sarah, but he did not actually propose.	Sarah; however, he did no actually propose.
people just basically beat on each other and scream and stuff.	People often come into conflict with each other both physically and verbally.
a chick from my church lauren h.	A woman from my church named Lauren H.
If it was the Teenage Mutant Ninja Turtles, then I'd join them!	"If it was the ""Teenage Mutant Ninja Turtles"", then I would join them."
I'm not always rock & screamo & stuff.	I am not always into rock, screaming, and the like.
People are just retarded and want him money.	People are dumb and want him for his money.
but I'm not gonna die trying...	However, I am not going to overexert myself in the effort.
call up disney and find out if there are any available.	Contact Disney and find out if there are any available.
darn, i don't feel special anymore...	Sadly, I no longer feel our unique connection.
i will call u to help me.	I will call you for assistance.
no but i cried when simba's dad died (lion king)...that was before the mood stabilizer prescription came about lol	However, I cried when Simba's father died in the movie The Lion King, possibly because I was not taking mood stabilizing prescription drugs at the time.
youtube.com has alot of funny ads from the present also	Youtube has a lot of funny ads from the present too.
Here's me trying to sound out how it goes.	It's me trying to sound out how it goes.
why isn't a hemmoroid called an asteroid??	Why isn't a hemorrhoid called an asteroid?
Yo mama so stupid she put out the cigarette butt that was heating your house.	Your mama is so stupid she put out the cigarette butt that was heating your house.
If they do come back (i hope not) GOOD LUCK!	If they do come back, I hope not. Good Luck
my friend said if you learn the most simple 4 notes, you can play the whole song.	My friend said that if you learn the simplest four notes, you will be able to play the entire song.
If he is someone you like to be around I say GO FOR IT!	Ask him out if you like him.
I really do not have one favourite movie.	I do not have one favorite movie.
I want to keep the baby, but I am afriad he will be a freak.. any suggestions?	I am uncertain if I want to keep the baby or not. What are your thoughts?
yeah they were twins.. played pretty well.. i believe one was called heather and the other was heidi.	I believe their names were Heather and Heidi. They were great athletes.
Plus, really hot for an older man.	He is handsome for an older man.
im chuck norris...my name says it all	My name is Chuck Norris.
if my pet bird gets too flappy, my pet kitty cat might eaty	My cat may eat my bird if it flaps its wings.
''she's like the wind'',from dirty dancing.	"""She is like the wind"" is from the movie Dirty Dancing."
hope this isnt a trick question , but im thinking TWO	I hope this is not a trick question, but I am thinking two.
I guess he's a good enough looking guy (his wife is a GODDESS)!	I guess he is a good enough looking guy, his wife is a goddess though!
I love that show and I keep watching the reruns	I am very fond of the show and continue to watch the re-runs.
The cop says, It has your picture on it.	The police officer states your picture is on it.
charlie & the choclate facotory was cool heres the link for the movies that he was in	"""Charlie & the Chocolate Factory"" was very entertaining and I have provided a link to more movies featuring the actor."
hell no your idiodic for asking.	Absolutely not and I feel you are an idiot in posing the question.
only you, if you met those people on the way dosent mean you take them all with you!!!!!!	Meeting people along the way does not mean they stay with you, therefore, it is you alone.
What if a dead person escape from cemetery?	What if a dead person escaped from a cemetery?
just enter a ton of talent shows.	Enter many talent shows.
my son loves it and i think its pretty cute too.	My son loves it and I also think it is endearing.
SO GIVE ME YOUR FUNNY DREAMS PEOPLE!	Tell me about your funny dreams, everyone.
How dare he call her kids - orphans.	"How does he have the nerve to call her children ""orphans""?"
coz there have been hints in many of the stories abt archie marrying betty.	There have been many hints of the stories about Archie marrying Betty.
It's like, equally offensive to everyone!	It is equally offensive to everyone.
im going to see them in may and i cant freakin wait!!!!!!!!!	I am going to see them in May and I can not wait.
sounds weird but try the Goodwill store they have tons of fancy stuff people dont want anymore	I know it sounds weird, but try the Goodwill store.  They have tons of fancy goods that people don't want anymore.
Dress her up as a Choirboy ...	Dress her up to look like a Choirboy.
The only reason I watch it now is because Tom Welling is sooo HOT!!!	I watch the show because I think that Tom Welling is so attractive!
my fav book is naruto books!	My favorite books are Naruto books.
Yo mama so stupid she put lipstick on her forehead, talking about she was trying to makeup her mind.	Your mother is so stupid. she put lipstick on her forehead and said that she was trying to makeup her mind!
my husband got me hooked on it but i haven't watched much of it this season.	My husband got me interested, but I haven't watched very much of this season.
mmmmmmmmmmmm.... yeah kinda i guess not really ive seen better	Yes, I suppose. No, I have seen better.
Cry me a river Don't know who origanly sang it.....	I am sure you are upset. I don't know who originally sang it.
Maybe I'm just stupid but I didn't get it.	Perhaps I am ignorant, but I did not get it.
when I was 9 I got Milli Vanilli for birthday	When I was nine, I received Milli Vanilli for my birthday.
Did you ever hear of a kleenix?	Have you ever heard of Kleenex?
I know i know u seen funnier but it still makes me laff :)	I know that you'll say you've seen funnier, but it still makes me laugh.
i was once told that i looked like timothy hutton, but i was young then.	I was once told that I resembled Timothy Hutton, but I was young then.
to me it's very confusing and more like a mini movie.	To me, it is extremely confusing and more like a miniature film.
first don't tell anyone you know you will never live it down.	Never tell anyone you know - otherwise, you will never live it down!
if he's so bad a veggie that even eating animal crackers seems a crime, we cant help it.	There's nothing we can do if he's such a strict vegan that he can't even consume animal crackers.
Jennifer Hudson - I Have Nothing	"I like the Jennifer Song called ""I Have Nothing""."
5'9... And if this is true, her twins will become giants!	"If it's true that she's 5'9"", her twin children will be giants!"
my grandma kicks ass with her cane.	My grandmother is very severe with her cane.
i would choose gilmore girls because they are so sarcastic	I chose the Gilmore Girls because I think they are sarcastic.
haha, I think it turns red when he's angry and yellow when it's cold!	I believe that it turns red when he is angry and yellow when he is cold.
Vince Vaughn he is fucking Hilarius and also pretty good looking	Vince Vaughn is hilarious and attractive.
Yo mama's so stupid, when they said they were playing craps she went and got toilet paper.	Your mother is so unintelligent that when they mentioned playing Craps, she retrieved the toilet paper.
well... if it's really you in the photo, then 15 shots of 151 i guess, straight!	If that photo is of you, I think 15 shots of 151.
yep they are all right.. good song hey.	Yes, they are all right - a good song, correct?
becuase in one of her songs she talks about saying no to sex pressure from her boyfriend	"Because in one of her songs, she discusses saying ""no"" to sexual pressure from her boyfriend."
i have three: gjkcenvb, typlmkeg, and jhdenbds	I have three: gjkcenvb, typlmkeg, and jhdenbds.
And b4 it was no egg so... CHICKEN!	Before it was not an egg so Chicken!
for modern music Paranoid Android - Radiohead	For modern music Paranoid Android by Radiohead.
you so need to rent the swetest thing!!!!	You so need to rent the sweetest thing!
im hopin that either a sith or scorpion will come out and i can fight them!	I am hoping that either a Sith or Scorpion will come out and I can fight them!
I think she did for the frame, IDK	I am not sure, but I think she did it for the fame.
well, i would say brad pitt, if he hadn't broken up with jennifer aniston.	I would be inclined to say Brad Pitt, if he had not broken-up with Jennifer Aniston.
she could tick or treat over the phone	She could trick-or-treat over the telephone.
nothing a little kryptonite wouldn't fix	It is nothing that a little kryptonite would not fix.
I think she is going to leave his ass.	I think she is going to break up with him.
Kellie, Katharine, Chris, and Ace for sure!	Definitely Kellie, Katharine, Chris, and Ace.
the mask :) i saw it over 100 times and i still laugh a lot.	"""The Mask."" I have seen it more than one hundred times and it still amuses me."
Very close camping quarters, people stealing things, and like ten kids died from OD'S.	Very close camping quarters, theft was common, and about ten children died from overdosing.
zero--- but free airfare,hotel,and meal/daytime expenses paid	None, but free airfare, hotel, and paid meal/daytime expenses.
kazza or limewire and i think eztrackz	Use Kazza or Limewire, and also Eztrackz.
Someone in between...best of both worlds!!	I'm somewhere in between, it is the best of both worlds.
all are good movies u cant rate them	You can not rate them because they are all good movies.
burn them as audio CD's ... that makes them .cda  Some players still don't play CDR's though.	If you burn them as audio CD's it will make them a .cda; Some players still will not play CDRs however.
Oh, I don't agree with you.	I do not agree with you.
Said, If you're gonna play the game, boy, ya gotta learn to play it right.	"He said, ""If your are going to play the game, boy, you have to learn to play it correctly""."
If you have to ask though, the answer is no!	If you must ask, then the answer is no.
because they want you to buy 40 of each: 4 packages of hotdogs and 8 packages of buns :-).	Because they want you to buy 40 of each: four packages of hot dogs and eight packages of buns.
not everyone hates him but i don't really like him that much	Not everyone hates him, but I do not like him very much.
Plus she is a cray ****.	Also, she is a mentally unstable woman.
It goes.. 1.Chris Brown 2.Bow Wow 3.Omarion	The order is: 1) Chris Brown, 2) Bow Wow, and 3) Omarion.
well my opinion would to be to make one yourself.	In my opinion, you should make one yourself.
I don't really want answers with.. oh thats sweet just follow your dreams ors omething you know	"I do not really want answers that say ""Oh, that is sweet, just follow your dreams"" or something similar; Do you understand what I mean?"
I am looking for aladdin's cartoon tv series on dvd......where can i get it?	"Where would I be able to find the ""Aladdin"" cartoon series available on DVD?"
well if one brick is 1.5 lbs and you have 1.5 bricks then the answer would be 2.25lbs	If one brick weighs one and a half pounds and you have one and a half bricks, then the answer would be two and a quarter pounds.
that all depends on what types of sites you like	That depends entirely on what type of websites you enjoy.
These animation studios sure like to orphan or partially orphan the kids!	These animation studios often write plots in which the characters are orphaned.
Because he takes it for granted that people need proper humour!	He assumes that people need good comedy.
I LOVE  HIP-HOP,RAP,ROCK & POP BUT MY FAV MUSIC IS R&B	I enjoy hip-hop, rap, rock 'n roll, and popular music, but my favorite genre of music is R&B.
yes , bcuz he is chan.	Yes, because he is Chan.
I do and I am way over 17.	I do,and I am way over seventeen
Great voice, and, er, easy on the eye.	Great voice, and easy on the eye.
who could come up with so many V words?	Who could come up with so many V words?
my sis looks like karishma kapoor, a very famous hindi movie star.	My sister resembles Karishma Kapoor, an extremely well-known Hindi film celebrity.
And, of course, the comic strips were and always will be awesome!	Also, undoubtedly, the comic strips were and shall continue to be awe-inspiring!
THis is one way to keep it out of your system....  Dont be stupid and use it!	This is one method for preventing it from entering your system. Refrain from stupidity and utilize it!
lol...what ever makes you feel good...lol	Anything that inspires positive feelings.
A minute or so later (I c	A moment, more or less, from then.
The egg is frowning and looks a bit pissed off.	The egg is frowning and it looks a bit pissed off.
c'mon  he can't even wipe his own butt but can speak intelligently?????	He can't even wipe his own butt but he can speak intelligently?
Alan moore is whining that it isn't	Alan Moore is whining that it's not.
i love the guitar player and how they can play in solos.	I love the guitar player and when they play solos.
Did you REALLY pay money to see that?	Did you really pay money to see that?
you better love them cause they are hotter than any of you boys out there !!!!!!	I hope you love them - they're the most attractive boys out there!
I got porn even with Norton AntiVirus	Even with Norton AntiVirus, I am able to access pornography.
If she isn't interested, her loss.	If she is not interested, it is her loss.
you dont get it cause your blonde	You do not understand, because you are blonde.
Yeah, what's up with that do?	What is the reason for that style?
Look to see if the baby is drooling from both sides of his mouth.	Look to see if the baby is salivating out of both sides of his mouth.
why limit yourself to one thing.	Why limit yourself to one choice?
In between cuz u want a man who knows what he wants but is good to u.	You want a man that knows what he wants and also treats you well.
I was just talking about Faith No More...	I was just talking about faith.
Diary of a mad black women it is funny	The Diary of a Mad Black Woman is funny.
I've got it, it's a tune!!	It is a tune.
it sure helps to have a hottie staring in it!	It helps that there is a handsome man as a star in it.
i would get about three or four logs.	I would use three or four logs.
Lynn, because she is the funniest.	I like Lynn, because she is the funniest.
no online ringtones are ever free	It is never free to use an online ringtone.
SAW was 10x better than SAW2	SAW was ten times better than SAW2.
Yo mama's so stupid, she thought a lawsuit was something you wear to court.	Your mother is rather unintelligent as she believed a lawsuit was something you wear to court.
i had milli vanilli & a compilation of air supply songs...LOL!	I had Milli Vanilli and a compilation of Air Supply songs.
...what about romance, aka chik flik?	"What about a romantic film, in other words, a ""chick flick?"""
he asks again a little irritated, girl says,nope.	"He asks again, slightlly irritated, until a female replies, ""Nope."""
of course she's dumb, her husband doesn't even love her, she's too weak.	Of course, she is not the smartest. Her husband does not even love her because she is weak.
and how good of a president do u think he would be?	How good of a president do you think he would be?
i worry when you get to me.	I worry when you get to me.
what kind of animation do you do?	What kind of animation do you do?
I hate RBD too...they are old guys and housewifes dressing like high school kids!	I do not like RBD either; They are older men and housewives dressing as high school students.
MAYA'S HUSBAND- DARNELL, BECAUSE HE IS SO CUTE.	Maya's husband Darnell because he is very attractive.
u mean all actors who've ever played superman?	Do you mean all the actors who have ever played the role of Superman?
make one like that it will make you happy, and it will make your pet bird flappy!	Make one that will make you happy and make your pet bird excited.
simple plan of course ya better like em!!!!!!!!!!!!!!	The simple plan of course is that you best like them.
I really like that song true love ways	"I like that song ""True Love Waits."""
I am just glad that gideon guy is gone, he was annoying.	I am just happy that Gideon Guy is gone, he was frustrating.
yeah turned me into a human hose pipe .	It turned me into a human hose pipe.
Plus Tupac wouldn't go for that ****.	Tupac wouldn't go for that person.
hope it doesn't eat your brain from the inside out	I hope it doesn't eat your brain from the inside, out.
I think he'd be alot more liked if he wasn't so outspoken about politics.	I think that he would be liked a lot more if he were not so outspoken about politics.
try limewire.com its free, you have to download it.	Try Limewire.com; It is free but you have to download it.
of course... animal crackers are made to be delicious and cute.	Animal crackers are baked to be delicious and cute.
It's one of my all time favorites!	It's one of my favorites.
doyle brunsen wrote an excellent book if ya havent read it yet.	You might not of read Doyle Brunsen's excellent book yet.
I don't pick them in the first place.	I didn't get to choose them in the first place.
I just watched that movie M.C.	I just watched that movie.
i dont know and didnt see it	I do not know and did not see it.
it depends on what kind of music u like.if u r into rap check 2pacs letter to my unborn	"It depends on what kind of music you like. If you like rap, you should listen to ""My Unborn"" by 2PAC."
thats the stupidest thing I have ever heard.	That is the stupidest thing I have ever heard.
lol i know what they're called, udders!	"I know that they are called ""udders."""
I want my Cd to play in my car's CD player and in my walkman.	I want to play CDs in my car's CD player and in my walkman.
Yo mama so stupid she sold her car for gasoline money!	Your mother is so stupid she sold her car for gasoline money!
i do i'm a girl and only lesbian pornos turn me on	I am a woman and I enjoy lesbian porn.
Don't worry, I got your back!	Do not worry, I support you!
i'd probably drink up everything in the damn bar to even think of finding u attractive.	I would probably drunk everything in the bar to even find you attractive.
srry i didnt c it yet but every 1 else ruiened it 4 me!	Sorry, I did not see it, yet. But, every one else ruined it for me.
A weird question :) I don't like them both, but Salvador Dali is more talented definitely.	This is a strange question; I do not like either of them, however Salvador Dali is certainly more talented.
yes, and how did u get the beans above the frank?	Yes. Can I ask how you put the beans on top of the frank?
I guess they can't eat gummi bears either.	I assume they can not eat Gummi Bears as well.
people should not be afraid of thier government, government should be afraid of thier people.....	Citizens should not have to feel afraid of the governement. The government should be afraid of the reactions of citizens if it is in the wrong.
They just want to express what they like and making a banging tune  :)	They are simply interested in expressing themselves, and creating a lively tune.
I would not want a funeral party thrown for me  Thanks anyway!!!	Thank you for the thought, but I would not desire to have a funeral party in my honor.
there was a brunette team and a blonde team.	The teams included a brunette team and a blonde team.
(not to be mean, just lettin you know) :)	I do not intend to be mean, I am merely informing you.
She's as trampy as the others!	"She has the same amount of undesirable ""tramp"" characteristics as the others."
Cheech and Chong's Up In Smoke	"Cheech and Chong created ""Up In Smoke."""
i have too many ,but maroon 5 and life house are my favorites absolute , and the all songs	I have too many. However, 'Maroon 5' and 'Lifehouse' are my absolute favorites, including all their songs.
i love his music, its sad that ppl accuse him of molesting children	I am a fan of his music. It is sad that people accuse him of molesting children.
You Love THEIR SONG which JUST SO HAPPENS to be THEIR MOST POPULAR.	You like the song which just so happens to their most popular.
Kinda sad, cuz I grew up with one.	It is a bit sad, since I grew up with one.
eww....once again....eww.....if you want to see a hot guy look up ville valo or bam margera....	I do not find this attractive and recommend you research Ville Valo or Bam Margera to view a physically attractive man.
I've worked on yachts for the past 30 years & met lots of celebs.	I have worked with yachts for 30 years and I have encountered many celebrities.
Mine would be Milli Vanilli and Vanilla Ice and Snow - YIKES!!	My choices would be Milli Vanillie, Vanilla Ice, and Snow.
Said, If you're gonna play the game, boy, ya gotta learn to play it right.	If you are going to play the game you must learn to play correctly.
Now there's hundreds of thousands of guys out there dreaming up a chance to date her.	Now, there are hundreds of thousands of males in existence dreaming of an opportunity to date her.
rabbit feet only work on ppl, not the rabbit they came from	Rabbit feet only are effective for people, not the rabbit they stemmed from.
techno it just grabs your spinal chord and makes it dance	Techno simply grasps ahold of your spinal cord and forces it to dance.
This is sooo funny, it has perverted humor to it.	This is rather humorous, but it has perverted humor.
it is totally a chick show.	It is a completely feminine show.
i also used to work in goverment.	I also onced worked in government.
One guy says to me 'So, where's the fox from Mystic Pizza?'	"One male asks me, ""So, where is the fox from Mystic Pizza?"""
If she's got a cane, then you can run and not worry about her catching you!!	If she has a cane, then you can run and not be concerned with her catching you.
I still am and aaliyah was a good singer i miss them both	I still am, and Aaliyah was a good singer; I miss them both.
Yo mama's so stupid, she thought Chubby Checkers was a game for fat people.	Your mother is rather unintelligent, she believed Chuby Checkers was an event for obese people.
yea we are trying ourselves to be a happy.	We are trying to be happy.
Bit by bit.....you win my love.	You win my love, little by little.
ive never heard of it sorry!	I apologize, I have never heard of it.
STEELERS WHEELS, SEE THE MOVIE RESERVOIR DOGS LOL!	Watch the movie Resevoir Dogs.
I would have to say White Chicks and Dumb and Dumber	"I would have to say ""White Chicks"" and ""Dumb and Dumber""."
Hey that would be a good cartoon for Gary Larson...two pigs laying in bed watching Deliverance.	"Two pigs lying in bed watching ""Deliverance"" would be a good cartoon for Gary Larson."
Jerry Springer b/c David letterman is a pu$$y LOL	Jerry Springer because David Letterman is too afraid.
No Paris or Mandisa will win i'm sure	No, I am sure that Paris or Mandisa will win.
Thank u. i'm bi 2, so thats y i asked.	Thank you; I am also bisexual so that is why I asked.
The Rock for hot steamy sex!	The choice would be The Rock for passionate romance.
cause you met them on the way, but that doesnt mean that they went with you.	And just because you met them during your travel, does not signify they traveled with you.
Yeah sometimes when I need alot of help.	Yes, when I do need quite a bit of assistance.
must be mp3 and able to play on i tunes	Two requirements are that it must be an mp3, and be able to be played on itunes.
Perfect Man Knows who I am and approves	The perfect man knows who I am and approves.
So far i haven't heard that shes come back here (Arkansas)?	So far I have not heard that she returned to Arkansas.
he benn traveling all over the world and he became a aduld with alots of postcards	He has been travelling the world and became an adult with many postcards.
Whats all these homies dissin' my girl?	Why are all these men being rude about my girlfriend?
Those being Rubber Soul, Revolver, Sgt.	"Those would be ""Rubber Soul,"" ""Revolver,"" and ""Sgt. Pepper's Lonely Hearts Club Band."""
Wow, that was a hard one.	Wow, that was a hard one.
<3 i just love a Harry Potter, lol	I love Harry Potter.
I dunno... but I think they would be just as pathetic sounding as the Rolling Stones are now.	I do not know but I think they would be just as pathetic sounding as the Rolling Stones are now.
how do u mean, let you get to you?	How do you mean, let you get to you?
me and my kids love that show!	My kids and I love that show!
he just made me dinner :D	He made me dinner.
Hell yeah I listen to them every freakin morning!!!	I listen to them every morning.
the jeeney said they had 3 wishes, one for each of them.	The Genie said they have 3 wishes, one for each of them.
Have you ever listened to Mad Season, if not you really should.	Have you ever listened to the band Mad Season? If not, you should.
ya sometimes but it funs reading thm and always remeber the +ve things forget the negatives	It is fun reading them and remember the positive things.
girls feel that they have to be like celebrities or no one will like them but that's not true.	Girls feel like they have to be like celebrities or no one will like them.  That is just not true.
he's the gooofball in all of us	He is the goofball in all of us.
i don't/can't have an outgoing life.	I do not/can not have an outgoing life.
Pretty much quit in my late twenties.	I pretty much quit in my late twenties.
Don't even get me started listing them.	Please don't ask me to list all of them.
Manchurian Canidate and Mean Girls oh yeah Mona Lisa Smile	"Some of my favorite films include ""Manchurian Candidate"" and ""Mean Girls"" and ""Mona Lisa Smile."""
He picked Sarah but rumour has it that they have already broke up.	He chose Sarah but, according to rumors, they were no longer dating.
tell you want to marriage him.	I suggest you let him know that you want to marry him.
GIRLFRIENDS IS ONE OF MY FAVORITE SHOWS.	"""Girlfriends"" is one of my favorite shows."
Also, his gf is a singer!	Also, his girlfriend is a singer.
best buy has alot of hard to find movies and series	Best Buy has many hard-to-find movies and series.
Do we really WANT them to get together?	Do we actually want them to get together?
Could also try: Wedding Crashers or The 40 yr old virgin	"You could also try ""Wedding Crashers"" or ""The 40 Year Old Virgin."""
shut up and drive by chely wright	"Chely Wright performed ""Shut Up and Drive."""
there was a female brunette, a blonde, and a red head walking down a street.	A brunette female, a blonde, and person with red hair walked down a street.
she saw a blonde on the other side.	She observed a blonde on the opposite side.
i hope that answers your questions	I hope that answers your questions.
a gentleman with me, and a thug when needed hehehee	He should treat me like a gentleman would, and behave roughly when needed.
I LKE THEM ALSO THEY ARE SOOOO CUTE!	I like them; also, they are adorable.
now think about how many people he is hurting by keeping all his money for himself	Now consider how many people he hurts by keeping all of his money for himself.
secondly id pick yellow card then simple plan then bowling for soup and finally red hot chilli peppers.	Second, I would choose Yellow Card, Simple Plan, Bowling for Soup, and finally, Red Hot Chili Peppers.
i think that celebrities are a horrible influence	I believe that celebrities are horrible influences.
There's a funny joke for Rap.	There is a funny joke for a rap.
Tom Cruise is in it...which to me is the definition of a movie that looks like crap.	Tom Cruise is in it which I feel makes it a poor movie.
don't know but they'll look good together.	I do not know but they will look well together.
She has a lot more movies and Katie has what - Like 3 ??	She has more movies, what does Katie have? I believe it is three.
she used to be a role model to little girls.	She used to be a role model for little girls.
pls answer i really wanna know.	I would really appreciate an answer.
and i dont look back another song by gary .	I don't look back which is another song written by Gary.
Who r u looking 4. is it me.	Who are you searchign for? Is it me?
and just tried to pull those dangly things!!	And just tried to pull those dangling items!
I didn't realize you were a cop, too.	I did not realize that you were a cop as well.
Oh yeah, is it 2d or 3d?	Oh really? Is it two-dimensional or three-dimensional?
but i'm a pure veggie and i love 'em.	I am a pure vegetarian, however, and I love them.
iano but thats such a good song.	I don't know, however, that is quite an excellent tune.
i bet he would be better than bush	I wager he would be more beneficial than Bush.
try purevolume.com... there are free mp3 downloads there	Sample purevolume.com. They feature mp3 downloads at no charge.
A guy that went to my hubby's school....ready.....Urine Sample.	"A man that went to my husband's school - ready? - ""Urine Sample."""
I missed it last night... but I want Kevin to go.	I missed it last night, but I want to see Kevin go.
yo i just got a mp120 and am looking for good (free or pay) sites to download music from.	Hey - I just got an MP120 and I am seeking good sites (free or paid) from which to download music.
Is this Zombie your BF or ....?	Is this zombie your boyfriend?
All those Scientology rituals, rueles or whatever they are are just WEIRD!!	Scientology rituals and rules strike me as very strange.
Paris is Queen Bimbo, Jessica is just one of her many minions.	Jessica is just a silly minion of Paris.
the mosquito stops sucking after you slap it.	Mosquitoes stop sucking blood once you slap them away.
name your favorite movie actress or actor	Name your favorite movie actress or actor.
try horseback riding, I hear that is pretty risky...I hear Christopher Reeve actually died from it!	I heard that horseback riding is fairly risky and that Christopher Reeve actually dies from it.
I don't like them...they sound really awkward to me.	I do not like them because they sound fairly awkward to me.
Note to Hollywood: STOP REMAKING CLASSICS!!	"Here is a note for Hollywood, ""Stop remaking classics."""
Maybe you mean the 1960's The Apartment	"Do you perhaps mean the 1960's ""The Apartment"""
i don't know maybe you'll find it in her website	I am unsure, maybe you will be able to find it in her website.
the brick won't follow you around after you lay it.	The brick will not follow you after you lay it.
i tried to do a gun the other day wooops wasn't mine crap lol.	I attempted to do a gun the otehr day, it was not mine.
i think sometimes they r, but dont center ur whole life around them.	I believe they are somtimes, I do not think you should center your life around them.
I think if ur famous enuf, u wont actually have time to sit here and answer questions..	I believe that if you are very famous, you will not have enough time to sit here and respond to questions.
one of them is Aishwarya rai , Indian celeb	One of those to consider is Aishwarya rai, an Indian celegrity.
They had alot of good stuff in the 90s!	There were a lot of appealing items in the 1990s.
i just wanted to tell you that i love superman!	I just wanted you to know that I love Superman!
i tape stuff on tape but i watch DvD's	I record a lot of shows, but I also watch DVDs.
yes i watched it i loved it	Yes, I watched it and I loved it.
i love green day im a big fan	I love Green Day and I am a big fan.
thats not funny...i dont think she'll appreciate it	I do not think that is funny and I don't think that she will appreciate it either.
they are a pretty good band I like them a little.	I think they are a pretty good band and I I like them a little bit.
Guns n Roses....why oh why did Axel's ego have to destroy our generation's rolling stones???	It is unfortunate for Alex's ego to destroy Guns n' Roses, which was our generation's version of Rolling Stones.
Tyra, she is a lot more pretty.	I prefer Tyra as she is more physically appealing.
its good to have a guy that can treat u nicely, but at the same time act gangster	It is desirable to be in a relationship with a man who treats his partner respectfully while standing up for himself.
One of my best friends is a Cap.	A very close friend of mine is a Cap.
3 if you meen members but 2 zs in zztop	The answer is three if you are referring to the number of band members, although there are two 'z's in ZZ Top.
Lots of my friends think about them too.	Many of my friends think about them as well.
Do you know good places to become a movie starin New england?	Do you know good places to become a movie star in New England?
I like a guy that may be a bit of a bad boy (tattoos etc.	I like a guy that may be a bit of a bad boy with tattoos et cetera.
Your mommas so fat...  when she gets thrown in the air she gets stuck!	Your mother is so fat when she gets thrown in the air she gets stuck!
I think it was Edwin Starr	I think his name was Edwin Starr.
pretty big if you are chewing bubblicious...lol	Pretty big, if you are chewing Bubblicious.
All I need is money, Love	All I need is money and love.
it is talking about how he won't betray or leave her.	It is saying that he promises not to leave or betray her.
8 mile is the real deal.	It is really eight miles.
Angel Baby (remixed by mr.Kapony) because it reminds me of my old angel baby	"I like ""Angel Baby"" as remixed by Mr. Kapony since it reminds me of my sweetheart."
All you people here who say you love American Idiot suck.	Everyone who says they love American Idiot is wrong.
Let me guess, you're a republican.	I assume, you're a republican.
does anyone know what the url is?	Does anybody know the url?
That way you get to do the dumping first.	That way you dump him first.
But shoot..anyone could of said that!	Anyone could of stated that.
i'm the first, but i don't need to submit, after me, i guarentee at least 10 more	I'm first, after me, I guarantee at least ten more.
ps:raveena tandon's known 2 throw a mean punch so watch out!!	Raveena Tandon has been known to throw a mean punch.
How about 'The Cowboys' when John Wayne kicks the crap outta Bruce Dern?	"What about when John Wayne kicks Bruce Dern in ""The Coyboys""?"
it take a little while to get use to it.	It takes some time to get use to it.
use a tissue throw it away	Use a tissue and throw it away.
He sound like a nice guy!	He sounds like a nice man!
they know they aren't getting a good seat :confused:	They know that they are not getting a good seat.
i ate the chicken and then i ate his leg lol thats from a beastie boys song...egg man?	""" I ate the chicken and then I ate his leg"" is from a Beastie Boys song, maybe Egg Man."
Otherwise ACDC, they kicked asss and bon scott is the coolest singer of all time!	Otherwise AC/DC, they kicked ass and Bon Scott is the coolest singer of all time.
7th heavens ok but it isn't relatable at all.	7the Heaven is ok but it isn't relatable at all.
just imagine what this person can do...and he or she can get away with it...oh!	Just imagine what this person can do and he or she can get away with it.
speedy gonzales was effing annoying as hell and tom and jerry were too innocent	Speedy Gonzales was annoying and Tom and Jerry were too innocent.
'slither' or 'stay alive' there good movies.	"""Slither"" and ""Stay Alive"" are good movies."
I went to St Ives.. the man and all his 'problems' were going the other way... :-)	I went to St. Ives; the man and all his problems were going the other way.
If it is like most, they should can their advertising agency!	If it is like most, they should replace their advertising agency.
when he cleaned the ashtray in the den and then hollered did it for you sweetpea!	"When he cleaned the ashtray in the den, then shouted: ""Did it for you, sweetpea!"""
this question reminds me of that song.	This questiong reminds me of that song.
THATS HOT i love Tinkerbell though	I like Tinkerbell.
george clooney hands down...he is so sexy!	My favorite is George Clooney. He is very good looking.
!...but it's time to move on	It is time to move on.
only way is an sharing program like limewire.	You can only accomplish this with a sharing program such as Limewire.
i love it... i also love verionca mars	I enjoy it and Veronica Mars.
Don't tell anyone I told you okay?	Please do not attribut what I told you to me.
And from Buffalo N Y  Thanks again	"And thank you again, ""From Buffalo, NY."""
your age...dude that one is old	Your age. That one is old.
rie-rie definitely deserves the points on this one, good work!	Rie-Rie definitely deserves the points on this one. Good work!
Hehe... You know the Beta team from YA are all wanting to answer these...	Did you know that the Beta team from YA are all wanting to answer these questions.
i don't think but...more just throwing a reasonable name out there instead of my honest opinion	I do not think so.   I am more of just throwing a reasonable name out there instead of giving my honest opinion.
No the Banjo playing would not.	No, the Banjo playing would not.
lin took the words right out of my keyboard.	Lin took the words right out of my keyboard.
yap... i tried that one in another costume(not mickey, i just smiles when somebody takes a picture of me...lol...	Yes, I tried that one in another costume, not Mickey, I just smile when somebody takes a picture of me.
I love both them gurls, especially Aaliyah.They in heaven smiling down :)	I love both of the girls, especially Aaliyah, They are in heaven smiling down.
from men Mccartney and girls Lindsay Lohan	From men McCartney and Girls like Lindsay Lohan.
chris ace or taylor for the guys and mandisa katherine lisa for the girlies.	I would say Chris Ace or Taylor for the men, and Mandisa, Katherine, Lisa for the women.
lol my family is NOTHING like that	That is funny. My family is not anything like that.
Him or his music or both?	Do you feel that way about him, or his music, or both?
if there's a fist fight between the two, then the rock would win.	If there were to be a fist fight between the two, The Rock would win.
Not as akward as some whiny brat crying about his daddy and skateboard!	Not the same level of awkwardness as a random undisciplined child bawling regarding his father and skateboard!
I saw something on TV that said he did, is it true???	I viewed some information on television that indicated he did, is that an actual fact?
jumped on the bandwagon and made the term so vague that it barely means anything anymore.	Hopped onto the bandwagon and rendered the word so unfocused that it hardly has a definition any longer.
i love abercrombie and my i.d.	I adore Abercrombie and My I.D.
Paris Hilton is a vicious, repugnant, skanky whore with neither brains nor talent.	Paris Hilton is not a good celebrity.
Maybe u can use these for next year.	Maybe you can use these next year.
How much does IT weigh is what you were getting at right!!!??	Is your question: How much does it weigh?
r u a fan of them or something?	Are you a fan of them?
red hot chilli peppers,simple plan,bowling for soup,yellow card or fall out boy	I would say Red Hot Chili  Peppers, Simple Plan, Bowling for Soup, Yellow Card or Fallout Boy.
im pretty sure that it was kiss	I am almost certain that it was Kiss.
Friday, Next Friday, Friday After Next, or White Chicks	I would say Friday, Next Friday, Friday after Next, or White Chicks.
The blonde speeder digs in her purse, can't find it then asks, What does my license look like?	"The blonde digs in her purse and cannot find it. She then asks, ""What does my license look like?"""
That’s my and my boyfriend’s song!!	That is my and my boyfriend's song.
and wat do u mean bu bad stuf?	What do you mean by bad things?
Snoopy Come Home was the best!!	"""Snoopy Come Home"" was the best."
No, I don't know maybe there jealous!	I am unsure, but perhaps it is a matter of jealousy.
I didn't use to watch his movies cuz I didn't think he's good looking.	I did not used to watch his movies because I did not think he was good looking.
I have loved Green Day since Dookie and I still love, love, love them today!!	I have and still do love Green Day since Dookie.
my brother looks like kathy bates, only ugly.	My brother looks like an ugly Kathy Bates.
he could be strange, but he is not bad	He could possibly be strange, but he is not a bad person.
Yo mama so stupid she stole free bread.	Your mother is so stupid that she stole free bread.
get a webcam, record your self and youtube it.	Get a webcam, record yourself, and put it on YouTube.
LOL..Get real..Chris's number looked like the encore at a Genesis concert!	Be serious; Chris's number looked like an encore at a Genesis concert.
I'm going to go with the cow.	I am going to choose the cow.
The drunk gets mad and says, Go screw your sister.	An intoxicated man makes a rude remark.
We also spell 'color' as 'colour' and its not c O lin Powell it's C o lin.	"We spell ""color"" as ""colour"" and put the emphasis on the ""C"" rather than the ""O"" in ""Colin Powell."""
i love Lonely Nation and Golden	I enjoy Lonely Nation and Golden.
I think it has gotta be the end of the 3rd film.	I believe it is at the end of the third film.
I used to LOOOVE him, now I just don't anymore, but I don't really hate him.	I used to love him, but I do not anymore.
roll em into a nice tight ball and then flick em	Roll them into a tight ball and flick the ball.
can't touch this          it in charlies angels full throttle  but idk who sings it please help	"Who sings ""Can't Touch This"" in Charlie's Angels Full Throttle?"
All he could hear was,  BREATH IN, BREATH OUT, BREATH IN, BREATH OUT.	He could only hear the person breathing in and out.
He just needs to R.E.S.P.E.C.T... me & my pplz... lol	He needs to respect me and my people.
he needs 2 keep his hands weir they belong!!!	He needs to keep his hands where they belong.
I have no idea, but dubbing sucks ass.	I do not know, but dubbing is unpleasant.
8 mile is good but its old.	"""8 Mile"" is good but old."
Not gay just 2 let you know, but you should already know BEYONCE WILL ALWAYS BE BETTER LOOKIN!	I am not homosexual, just to let you know, but you should already know that Beyonce will always be more attractive.
u culd try researching it on google or try bestbuy and blockbuster	You could try researching it on Google.  You could also try Best Buy and Blockbuster.
Either Full House or Fresh Prince Of Bell-Air	Either Full House or Fresh Prince of Bel-Air.
does anybody no a web sight for a casting call	Does anyone know a website for a casting call?
it all depends on where you are getting your horscope from.	It all depends on where you are getting your horoscope from.
Mine is Sublime, their freakin great.	My favorite band is Sublime.
I LOVE IT ALSO I LOVE STUPID GIRLS THAT SONG ROCKS	"I also love the song ""Stupid Girls""."
he takes off and never goes home.	He leaves, but never goes home.
i dont know...the guy who made up the names had A.D.D.	I think the man who invented the names suffered from ADD.
Yo mama's so stupid, she tried to mail a letter with food stamps.	"""Yo mama's so stupid, she tried to mail a letter with food stamps."""
I like Classic Rock  But will listen to anyting but Rap never got into it.	I like Classic Rock but will listen to anything but Rap, never got into it.
count me in and I don't remember the names	count me in, and I do not remember the names.
..... ONLY A GUY WOULD DO THIS.	Only a guy would do this.
I mean your yelling, not singing.	Your singing sounds like yelling.
it depends what you think a miracle is	It depends on your definition of a miracle.
Its Paris Hilton but I don't care for either one.	it is Paris Hilton, but I do not like either one of them.
it wasn't on because of the game.. and the new espisode comes im march 27.. i think.. can't wait!	It was not not on because of the game and there will not be another episode until March 27, I can not wait!
Yo mama so stupid she thought a quarterback was an income tax refund.	Your mother is so stupid that she thought a quarterback was an income tax refund.
Yo mama's so stupid, she got hit by a cup and told the police that she got mugged.	Your mother is so unintelligent that she was hit by a cup and told the police that she was mugged.
I sure am glad, Stacie !	I am very glad, Stacie!
On a Picnic We Will Go	We will go on a picnic
My bum is already burnt... Wow you're smelling great!	My behind is burnt already, wow you are smelling great!
Whats your favoite movie and why?	What is your favorite movie, and why?
I just loved Bewitched and elf and all his other movies!	"I truly loved ""Bewitched,"" ""Elf,"" and all his other movies."
but wait... are you gay or soemthin?	Wait; are you gay?
he is hanging; is that really water at his feet?	He is hanging; is that actually water at his feet?
He probably said something like, We're not real.	"He probably made a comment such as: ""We're not real."""
jessica simpson is a blithering idiot.	Jessica Simpson is a blithering simpleton.
cuz kevin and katharine are gettin suspisous	The reason is because Kevin and Katherine are getting suspicious.
probably natasha bedingfield or james blunt, although they actually both suck really bad	It is probably Natasha Bedingfield or James Blunt. But I do not like either.
MJ will not have another hit album.	He will not have another hit album.
i like to watch them with my boyfriend	I like watching them with my boyfriend.
Kinda nifty - I might try that myself!	That is impressive- I might try that!
Nightmare on Elm Street Series it use to be scary and I like horror.	The Nightmare on Elm Street series used to be scary, and I like horror movies.
you don't pay for limewire it is free	Limewire is a free service.
fave band---dream theater fave song---always changing	My favorite band is Dream Theater and my favorite song is constantly changing.
im almost positive it was him.	I am pretty positive that it was him.
theyre not...its just a form of entertainment...a silly sort of competition...	It is a form of entertainment and a silly competition.
i love her she IS amazing   RIP	I loved her and she will remain amazing to me. I hope she rests in peace.
THE PARENTS STOP AND HIS MOM QUICKLY DISMOUNTS, PULLING THE COVERS AROUND HER.	The parents stop and his mom quickly dismounts, pulling the covers around her.
I have a VHS i never use it tho...so DVDs is in and will be for a long time	I have a VHS I never use. So, DVD's are in and will be for a long time to come.
there's just too much sexual content, and cursing in rap music.	There is too much sexual content and cursing in rap music.
he got so scared he jumped and had a heart attack.	He got so scared that he jumped and ended up having a heart attack.
“He was an evil man,” he said.	"He said, ""He was an evil man""."
I LIKE THAT SHE'S FUNNY BUT THEY MAKE HER A LITTLE HO-ISH AND SHE'S A MOOCHER.	I like that she is funny but they make her a little slutty and she is a freeloader.
A southern gentleman for a southern belle :)	A Southern Gentleman for a Southern Belle.
zap was the main killer's (dead guy in room) accomplice.	Zap, the dead guy in the room, was the main killers accomplice.
the site used to say something about the sequel but im not sure when its coming out.	The website used to say something about the sequel, but I am not sure of when it is coming out.
I don't want an opinion - I need the source from where you got it.	I do not want an opinion.  I need the source from where you got it.
Just me him and the stars, he would be my sex slave going where..... can't finish it's too cliche'.	Just the stars, him and I.  He would be my sex slave going where no man has ever gone before. I know it is so cliche'.
She flips the alligator over and yells, “Drat, this one doesn’t have shoes either!”	"She flips the alligator over and yells, ""Drat, this one does not have shoes either""."
when you both just sit there doing nothing but watching tv or something.	When you both just sit there, doing nothing but watching television or something of the like.
who makes fun of an orphan?	Who ridicules an orphan?
example: john likes collecting manga straight from japan.	An example: John likes collecting manga directly from Japan.
until the next season of the show.	Until the next season of the show.
Still trying to pick myself off the floor.	I still feel as though I'm picking myself up off the floor.
Just act like youve done it before and kick some a$$	Just pretend that you have done it before, and prove yourself strong.
that means all of them have green dots	That means that all of them have green dots.
=)  who do u thinks better?	Who do you think is better?
yea i feel i am an attractive person.	Yes, I feel that I am an attractive person.
i don't have a fave band but my fave singer is mariah carey	I do not have a favorite band, but my favorite singer is Mariah Carey.
she's just a tomboy and a good athlete, that doesnt make her gay!	She is a good athlete and tomboy, but that does not make her a homosexual!
I am a big superman fan, i bet u can tell by now.	I am a huge Superman fan, but I am sure you can tell by now.
I don't know if everyone does, but I sure do!	I do not know if everyone does, but I do!
my friends talk about me because i still blast his music through my apartment on a regular basis	My friends talk about me because I continue to blare his music in my apartment frequently.
why do you only got 1.5 bricks?	Why do you only have one and a half bricks?
I think they got the point	I believe they received the point.
he took a nice catholic girl and turned her into a scientology freak, katie holmes is EXTREMELY naive !	Katie Holmes was once a nice Catholic girl, now she's a Scientologist.
dvds have taken over the world!!!!!!!!!!	DVDs have taken over the world.
Persoanlly I don't like any artist over another ...	Personally I do not like one artist over another.
Because there is no such thing!!!!!!!!!	There is no such thing.
gretchen wilson, i think she's pretty	I think that Gretchen Wilson is pretty.
Randy is kind of weird at times....Paula seems so wimpy...Simon seems too cruel, at times!	Randy is a bit weird at times, Paula seems to be wimpy, and Simon seems to be cruel, at times.
it just didn't make any sense to me.	It simply made no sense to me.
Illutions always decieve u.don believe em	Never believe deceptive illusions.
Never Been Kissed...well not really but it is what I am watching right now!	"Right now I'm watching ""Never Been Kissed""."
yeah sometimes i like 2 listen to it.	I agree as I enjoy listening to it occasionally.
obviously hypothetical but just wondering about other opinions	This is obviously hypothetical, although I am curious concerning other opinions.
That's like Broke Back Mountain for little John Wanye.	"This is similar to ""Broke Back Mountain"" for a young John Wanye."
I have the cassette tape but I want to get that album on CD....	I do have the cassette tape but I want to get that album on CD.
I'm sure you'll both like it!	I am sure that you will both like it.
to stop the zombies from wandering around town.	To stop the zombies from wandering around town.
No but I know a guy.	No, but I know a guy.
Your boss likes you maybe a little too much excise caution !	Your boss likes you, maybe a little too much, exercise caution!
Its all about FEARFACTOR baby lol.	It is all about Fear Factor baby!
email me, maybe we can be friends!	email me, maybe we can be friends!
Wat did the beaver say 2 the log.	What did the beaver say to the log?
I thought it was him, too-but I can't say for sure!	I also thought that it was him, but I can not say for certain.
For every ones hand to be up you would have to of had a green dot.	For everyone's hand to be raised, you would have to have had a green dot.
Not me, I used to be in orchestra though.	Not me, however I used to be in an orchestra.
i wipe them on the floor or bed.	I wipe them on the floor or the bed.
put her in a circular room and tell her to sit in the corner.	You can put her in a circular room and tell her to sit in the corner.
Also work on your self image-it sound like that isnt very good right now.	Your self image does not sound very good at all. You should work on it.
he wanted to eat the mouse	He just wanted to eat the mouse.
NO I find this man to be disgusting.	I find this man to be disgusting.
i do...im not conceited but i no im pretty.	I am not conceited, but, I am pretty.
of course you should keep the baby its your fault you wanted to play but now you gotta pay.	of course you should keep the baby it is your fault you wanted to play but now you gotta pay.
and if floyd could do it im sure the beatles could yoko or no yoko.	If Floyd could do it I am sure the Beatles could yoko or no yoko.
Sleepy Grumpy Doc Sneezy Happy Dopey Bashful!	Sleepy, Grumpy, Doc, Sneezy, Happy, Dopey, and Bashful are the seven dwarves!
Tell them the phone bill and rent are due!	Tell them the phone bill and rent are due!
crap they have turned into long jokes  What has seven arms and sucks???	Shoot, they have turned into long jokes What has seven arms and sucks?
One muffin looks to the other and says...Gee, its gettin kinda hot in here!	"One muffin looks to the one sitting next to him and says, ""Gee, it is becoming very hot in here!"""
I would not kick either of them outta bed.	I would not ask either of them to leave my bed.
He better not let her go.	He had best not let her go.
wtf ur phto looks meesed up don't dress that way ppl migh think ur gay(no ofence)	I mean no offence but your photographed looks messed up, and if you dress that way people may think you are a homosexual.
I have the newest one and i get movies, music,pictures,and documents.	I have the newest one and I am able to get movies, music, pictures, and documents.
juss buy the god darn soundtrack!!!!!!!!!	Just go out and buy the soundtrack!
Plus, she needs to get a damn job!	And she needs to seek real employment!
So if theres anyone out there that completely inderstood the movie, can u pleeease fill me in on it???	Can someone who really understood that movie let me know what it was about?
Everything She Does Is Magic - The Police	"""Everything She Does Is Magic,"" by The Police."
Pilot Inspektor, Rainbow, those are celeb kids names there some other ones but i forgot them!	Pilot, Inspector, and Rainbow are celebrity children's names.  There are some other ones, but I cannot remember them.
What did we ever do to these guys that made them so violent?	What did we do to these guys to turn them so violent.
Even The Cure has love songs and most of their stuff is pretty dark.	The Cure has love songs and most of their music is pretty dark.
1) My fav genre of music is R&B.	I like Rhythm and Blue music.
it makes me so happy :)(i love jim carrey) :)	If makes me quite happy because I like Jim Carrey.
He dosn't need to change one thing!	He does not require a single change.
Yo mama's so stupid, her shoes say TGIF- toes go in front.	"Your mother is so slow here shoes are labeld TGIF, which stands for ""toes go in front."""
I wish I could meet my fave bands.I love rap music.GO RELIENT K!	I desire to meet my favorite bands and I am very fond of rap music, especially Reliant K.
or the lame toronto zoo answer: Woodchucks can't chuck wood.	"Another option is the Toronto Zoo answer of ""Woodchucks can't chuck wood,"" which is not a high quality answer."
on the way to the end, the chicken goes, weeeee!	"The chicken expresses the sound ""weeee"" while approaching the end."
i so far haven't lost an item yet.	I have not lost an item so far.
I liked Rudy when she was little and Theo when he was in high school!	I liked Rudy when she was a little girl and Theo when he was a high school student!
it might be an interesting show, but never got into it at all.	I am sure it is an interestingshow, but I just never liked it much.
No one will forget TLC..they made the anthem for girls I don't Want no Scrub ...LOL!	"I will always remember TLC because they made the anthem for girls, ""I don't want no Scrub""!"
AND I LIKE JOAN BECAUSE SHE IS THE MOST LIKE ME.	I like Joan because she is the most like me.
He just gave us a song to keep dreaming with and alot of us do.	He gave us a song to keep dreaming with and a lot of us do.
It depends on how much or what kind of gum u chew.	It depends on how much gum you chew and the brand.
showgirls,yes im ripping off that line, but true is true	I know I am quoting Showgirls but it is apt here.
I don't think she ever had it to begin with :).	I do not believe that she was ever that way.
You really don't want to meet women in the bars anyways...  Have fun this weekend!!!!!!!!	You do not truly wish to meet women in bars, and I hope you have fun this weekend.
your not you just lack self-confidence	You are not that way, you simply lack self-confidence.
try to download 360 share on your comuter	Try to download the app 360 share onto your computer.
LOL it depends who this elder is and why they're beating me with the cane.	It depends on who the older person is and why they are beating me with a cane.
The Chinese get the Rizza, the Jizza, and the Ghost Face Killer!!	In China, they have The Rizza, The Jizza, and the Ghost Face Killer.
other than that, i can't think of anybody else.	Other than that, I cannot think of anyone else.
Are you talking MPH are RPM????	Are you talking about MPH or RPM?
Yo mama's so stupid, she got stabbed in a shoot-out.	Your mother is so stupid, she was stabbed in a shoot-out.
Texas Chainsaw Massacre the new version	"""Texas Chainsaw Massacre"" has a new version."
But if you have cash, buy a Taylor or Martin...	But, if you have cash, buy a Taylor or Martin.
Forget it, you wouldn't understand, well at least I still have my Peggy Sue... Peggy Sue?	Forget it, you wouldn't understand, well at least I still have my Peggy Sue, Peggy Sue?
i do it is an awsome show.	I do, it is an awesome show.
How come no one mentioned EVIL DEAD!!	How come no one mentioned evil Dead!
Jesus Christ looks like me !	Jesus Christ looks like me!
Maybe you mean people in uniform?	Perhaps you are referring to people in uniform?
therefore it must be the chicken!	Therefore, it must be the chicken.
i would pretend to fight them then fall and play dead.	My conflict resolution style is based in passivity.
easy- shakespeare in love  and romeo and juliet  awsome romantics.	It is simple; excellent romantic films include Shakespeare In Love and Romeo & Juliet.
but paris hilton isn't far behind.	Paris Hilton is not far behind.
But has a lil slang 2 his walk.	He has a little swat to his walk.
well, so much for guessin' yours!!	Well, so much for guessing yours.
Your Mama's so ugly.........the cops gave her a ticket for indecent exposure.	Your mother is so ugly, the cops gave her a ticket for indecent exposure.
u must be too young,otherwise u would definitely know.	You must be too young, otherwise, you would certainly know.
it looks interesting to me, and whats it about?	It looks interesting to me, but what is it about?
i dont noe...and really dont care	I do not know or care.
they arent bimboes, jessicas a declared genius.	They are not floozies because Jessica is a declared genius.
:)  They always had pizza around, too!	They constantly had pizza around, too!
All my votes are going to Taylor Hicks though...	All of my votes are going to Taylor Hicks, though.
WHAT WERE YOU AND DAD DOING?	What were you and dad doing there?
Hi, I think u meant psychic...	I think you meant psychic.
I love SMALLVILLE so of course I wanna see who else loves SMALLVILLE!	I love Smallville, so of course I want to watch it.
some songs are 1,2, step by ciara.	One of the songs on the playlist is 1,2, step by Ciara.
2 POINTS SCORED ON THAT ONE	Two points were scored on that shot.
her iq is like 145, and paris isnt dumb!	Paris is not simple-minded, her Intelligent Quotient is around 145.
when you don't talk or go out with each other or maybe the relaship never started	Maybe the relationship never started because you did not talk or go out with each other.
You won't go wrong, if you watch this one!!!!!!	You will not go wrong if you watch this one.
i know who bam is though.	I know who Bam is.
The sound of the 2 together, wow I do love the sound lol =)	I love the sound of the two together.
YA KNOW THE DRUMMER FROM BLINK 182	Do you know the drummer from Blink 182?
I think its like, forever or something like that.	I think it is forever or something like that.
call information they will give it to you in a snap!	Call information and they will give it to you in a second.
just bcoz im a girl... i prefer ADAM SANDLER and ROB THOMAS!	I prefer Adam Sandler and Rob Thomas due to my femininity.
I can't sleep....I need to know.	I can not sleep and I must know.
I guess that means Simon likes blondes!	I suppose the inference is Simon's preference for blondes.
i mean who will fear beautiful women?	My intention is to question who will be afraid of beautiful women?
For me its definately Jessica Alba and Angelina Jolie....	For me it's definitely Jessica Alba and Angelina Jolie.
I loved all the characters and Bill Cosby was SO funny without being crude!	I loved all the charachters and Bill Cosby was so funny without being crude.
i don't know who ville is.	I do not know who Ville is.
I dun think he loves her	I do not think he loves her.
neither...not a big fan of either	I am not a fan of either.
celebrities are why there are so many anorexic girls now.	Celebrities are why there are so many anorexic girls.
how would you feel if someone threw you a funeral party at the age of 60 or 70?	How would you feel if someone held a funeral party for you when you are sixty or seventy years old?
I am listning to it right now!	I am currently listening to it.
Angelina Jolie much more sexy !!!!!!!!!!	Angelina Jolie is more sexually attractive.
why don't you urge the tv management?	Why do you not urge the television management?
yo mamas so stupid she went to disney, saw the sign disney left then turned around and went home	"Your mother is so unintelligent that she went to Disneyland, saw a sign saying, ""Disneyland Left,"" then turned around and went home."
WHAT WERE YOU AND DAD DOING?	What were you and Dad doing?
i totally love them they are so hor who else out there are dawgs that love BLINK 182 ????????????????????????	"I really enjoy them because they are so attractive. Are there other ""dawgs"" out there who love Blink-182?"
I just saw it last week.	I just saw it last week.
It's so funny, that's why i love it.	It is so funny; that is why I love it.
who knows... i guess it was just their time.	No one knows. Perhaps it was simply their time.
if that's the case you can wait a little longer can't you.	If that's the case, can't you wait a bit longer?
in an interview , boss; what is is ur wife name ?	The boss asked his wife's name during the interview.
i don't wanna brag or nothing, but i fu**ing rock!	I don't want to seem boastful, but I'm pretty awesome!
I THOUGTH IT WAS MISSOURI (ST. LOUIS)	Isn't it in Missouri?
I pick angelina jolie on this one~ even though it is awful that she stole brad from jennifer!	I think it awful that she stole Brad fron Jennifer, but I pick Angelina.
I also though Naomi Watts dress was really odd and looked a little too big for her also.	I thought Naomi Watts had an odd dress that looked a little too big.
rap, rock gives me such a headake	Rap and rock music makes my head ache.
I'd love to see either of them win!	I would love to see either of them win.
me and my dad together have bought about 1000 items.	Together, my father and I have purchased about a thousand items.
Tom Welling... looks a lot like the vocalist of The All-AMerican Rejects...^_^	Tom Welling looks a lot like the vocalist of the All-American Rejects.
:)) I don`t think so...I don`t hate him	I do not think that I hate him.
And i dont even need to be Gay!!!	I do not even need to be gay.
what kind of person  throw a funeral party?	What kind of person throws a funeral party?
thank you for letting me vent about this crappy crappy crappy band !	Thank you for allowing me to complain about this absolutely terrible band.
I Definitely would choose My Chemical Romance hands down!	I would definitely choose My Chemical Romance, for certain.
I don't trust anyone who can't find at least one Sublime song they like.	I do not trust anyone who cannot find at least one Sublime song to like.
tell him that you think you might be pregnant.	Tell him that you believe you may be pregnant.
duran duran, madonna one woman band!, alabama, exile and how could i forget... Air Supply!!	Duran Duran, Madonna (one-woman band!), Alabama, Exile, and I cannot forget Air Supply.
I don't believe your mama is stupid at all!	"I do not believe ""yo mama"" is stupid at all."
your ganna have to take guitar classes	You will need to take guitar classes.
and i won't let you get to me either!	I will not let you get to me, either.
and the blonde in the boat says, this is, like, a sea of wheat, duh.	"The blonde who was in the boat stated that it was ""like a sea of wheat""."
OK dear dont let it get to you	Do not let it get to you.
He's a businessman...he spends money on whatever he wants.	He is abusinessman and he decides to spend his money on whatever he wants.
Hoopz does not want Flav at all.	Hoopz was not interested in Flav whatsoever.
STOP BEING POSERS AND GET A LIFE	Stop attempting to be someone you are not and go out and live.
they both su*k. Paris is a dumbass no talent sl*t and jessica is jsut brain dead	Both actressses are horrible, Paris is not very smart, is promiscuous and does not have any talent while Jessica is just plain idiotic.
the last song of madonna's which i liked was american pie......sorry-think her time's almost up.	The last song of Madonna's that I liked was American Pie.  I think her time is almost up.
I don't believe Britney Spears is dumb although some of the things she may do are dumb	I do not believe Britney Spears is obtuse, even though some of the things she does are obtuse.
It is one of the best songs out there!	It is one of the best songs out there.
DEPENDING OMN THE GUM U CHEW	Depending on the gum you chew.
I like So Sick by Ne-Yo.	"I like ""So Sick"" by Ne-Yo."
But he has to be a gentelmen cuz he has 2 have a good job dat pays good money.	He has to be a gentleman because he has to have a good job that pays good money.
She is the greatest talk show host EVER!!!	She is the greatest talk show host I have ever watched.
KEVIN n nfnhfnigbubjbni.....I dunt really watch American Idol..........	Kevin, I do not really watch American Idol.
BEYONCE CAUSE SHE'S YOUNGER AND CAN DANCE BETTER	Beyonce is younger and she can dance better.
Escpecially when the chicken chases the guy in the end!	Especially when the chicken chases the guy in the end.
I dont even consider that a song.	I do not even consider that one a song.
oh ya and hes very hot.	Oh yeas and he is very captivating.
Aerosmith,Def Leopard and AC/DC and sorry I have 4; Boston too!	I have four favorite bands.  Aerosmith, Def Leopard, AC/DC, and Boston.
A little too excited if you ask me.	I think he's a bit too excited.
i have Liked Jennifer love Hewitt... she is so awesome and her bday is a day after mine!!	I think Jennifer Love Hewitt is great. Also, her birthday is only a day after mine!
why do they try to sound british ?	What is the appeal of sounding British?
Not everyone hates him but that is why some hate him....	That's why some people dislike him.
i don't think there is any chord like that.	I do not think there is a chord like that.
put icyhot or bengay i in his underware or on his deoderant	"Put ""IcyHot"" or ""Bengay"" in his underwear, or on his deodorant."
Yo mama so stupid she thought she needed a token to get on Soul Train.	"You mother is so stupid, she thought she needed a token to get on the show ""Soul Train."""
50 Cents movie Get rich or die tryin, or Eminem's 8 Mile?	"Do you prefer 50 Cents' film ""Get Rich or Die Tryin',"" or Eminem's ""8 Mile?"""
Pocket Taser Stun Gun, a great gift for the wife.	A desirable gift for one's wife might be a pocket taser stun gun.
But It Would Be Cool If They Did A SPECIAL ReUnion Episode Or Somethin( I LOVE That Show)	It would be enjoyable if they did a special reunion episode or something similar, as a I truly enjoy that show.
what are you doin back there?...lets go!!	What are you doing in that area? We ought to leave.
Zack Efron, he is the HOTTEST GUY ALIVE	Zack Efron is the mostr attractive man alive today.
And that damned burger King is creepy as hell.	That Burger King is completely unsavory.
Not me but i know alot of people that do	While I do not, many people do.
And you can pots your info for free!	You can post your information for free.
i cant wait to see the new movie!	I am so excited about the new movie.
if you don't like them don't answer, please	If you do not like them, please do not answer.
Well, I rather like Lucius Malfoy.	I am fond of Lucius Malfoy.
Tonto looks at Lone Ranger and says Doctor say you gonna die!	"Tonto looked at The Lone Ranger and stated ""Doctor say you gonna die""."
$10 per ticket to go see movies multiple times a week.	It costs ten dollars per ticket to go to the movies and that is done multiple times per week.
idk but i have another one: yo mama so fat she had to get baptized at seaworld.	Your mother is so overweight that her baptism had to take place at SeaWorld.
Rachel Fuller- Into My Heart maybe?	Rachel, was it Into My Heart?
then i changed to Nsnyc now i'm onto stephen speaks	Then I changed to Nsnyc now I'm onto Stephen Speaks.
LOL they are obviously stupid, not just confused!	They are obviously stupid, not just confused!
Moriaty etc, but who did the Peruvian play?	Moriaty etc, but who did the Peruvian play?
well its not really a book i guess but its kinda a long comic.	well it is not really a book I guess but it is kind of a long comic.
i'll be different and say vagina	I'll be different and say vagina.
I just need the name of the movie... Thx	What is the name of the movie?
HELL TO THE NO..THEY ARE ONE OF THE BEST BANDS OUT THERE.	No, they're one of the best bands out there!
We call it a Moo Moo, she calls it lingere.	We call it a muu muu, but she calls it lingerie.
!”   how do you know if a blonde has used the computer?	How can you tell if a blonde has used the computer?
I wouldn't believe that anyone could care!	I was surprised to find that anyone else could care about it.
and yes sometimes i dont come home until late.	Sometimes I come home relatively late.
Boulevard of Broken Dreams, and there new song Wake me UP When September Ends	"I like Green Day's ""Boulevard of Broken Dreams"" and ""Wake me up when September Ends"""
she used to sing with mpeople	She used to sing with the group MPeople
rock , we heard more great rock stars ,while not very much great rap singer.	Rock we heard a lot of great rock stars, but not very many great rap singers.
my little brother would ask something like that.	My little brother would ask a question like that.
Jason Momoa from Baywatch Hawaii, and North Shore!	"Jason Momoa from ""Baywatch"", ""Hawaii"", and ""North Shore""."
!I loved all of the CB movies and specials.	I loved all of the CB movies and specials.
yes there is a reset button	Yes, there is a reset button.
they make u think of who your with, and love them more than u did already	They make you think about the person you are with, and make you love them more than you already did.
I would prefer a bad boy(thug) with a gentlemen side.	I would prefer a bad boy with a gentleman side.
california girls by david lee froamerly with van halen	California Girls By David Lee Roth, formerly with Van Halen
One of the best & original movies that I have ever seen.	It is one of the best original movies that I have ever seen.
And with a great deal of therapy, may even walk again..   Man driving down road.	With a great deal of therapy, he/she may even walk again.
oh, greenday what happened to you?	Oh, Greenday what happened to you?
Plus I read this article about her being one of the highest paid actress out there.	Also, I read an article claiming she was one of the highest-paid actresses.
I dono I think that is the DUMBEST show EVER!!!!!!	I don't think it's a very intelligent show.
Yo mama's so stupid, she thought the internet was something you catch fish with.	"Your mama's so stupid, she thought the ""internet"" was used for catching fish!"
The man is like a fine wine, gets better with age :-)	He's like a fine wine - he improves with age!
And me being a long time Def Leppard fan...I'de have to pick any and all from them...LOL	Well, as a longtime Def Leppard fan, I would choose any or all of them!
I must have seen it in 1986 or something a barely remember all the details...CAN SOMEBODY HELP?	I must have seen it in 1986 or something I barely remember all the details. Can somebody help?
I believe that would be M.C.	I believe that would be M.C.
perfect answer dnt u think so?	perfect answer, don't you think so?
Good question... Simon kinda stumped me with that one too.	Good question, Simon kinda stumped me with that one too.
I haven` t missed a single episode!	I have seen every episode.
Do I gotta spell it out for you?	Must I provide greater detail?
You hit it on the money!	You are accurate.
Reel big fish, Chronic future are a couple...their awsome, plus the classics like ac/dc...etc	Two that are very good are Big Fish and Chronic Future, and then there are the classics such as AC/DC.
talk to people who work for disney.	You should talk to Disney employees.
I am not really liking Billie that much.	I am not really too fond of Billie.
Yo mama so stupid she took a spoon to the superbowl.	Your mother is so stupid, she took a spoon to the Super Bowl.
Yo mama so stupid that she sold the car for gas money.	Your mother is so stupid, that she sold the car for gas money.
there aren't any words that rhyme with orange.	There are not any words that rhyme with orange.
it is an awesome band with awesome vocals and lyrics!	It is a good band with strong vocals and lyrics.
yes.. try aries.. that is the one i was using	I recommend trying Aries, which is the one I was using.
if you will put where you live i can give you a better one.	If you supply your home address I can you a better one.
I really liked that movie and wasn't Brad Pitt hot in that movie.	I enjoyed that motion picture and liked looking at Brad Pitt in it.
but i dont watch him that much!	I cannot say I watch him frequently.
hey is there anyone famous on here?	Are there any famous people on here?
go to limewire.com and down load it	Go to the website limewire.com and download it.
Captain Picard, I like bald men and his accent.	Captain Picard, because I appreciate bald men and his accent.
this does happen, like in batman, when he was recoving and that blond guy took over for a bit.	"This does happen, as in ""Batman,"" when he was recovering and the blond man took over for a time."
), but has the heart of a gentlemen.	He has the heart of a gentleman.
the brunette team leader says to the blonde team leader, what are you guys doing?	"The brunette team leader asks the blonde team leader, ""What are you guys doing?"""
Alternatively, you could cheat- that's the second easiest way to win.	Alternatively, the second easiest way to win is by cheating.
Taylor Hicks...And why?.....cause he`s infectious with great talant ...TAYLOR HICKS ALL THE WAY!!!!	Taylor Hicks is infectious with great talent.  He is my favorite.
Can anyone help me with this?	Would someone be able to assist me?
i love it becauase i love the show and.....*goes on 4 so long she dies*	I love it because I love the show.
Reminds me of an old Beatles song	It reminds me of an old Beatles song.
Purple and Music I think are 2!	Purple and music, I believe are two.
he's crawling around with no feets!!!	He is crawling around without feet.
and the movie is double teamed.	"The movie is, ""Double Teamed""."
i am with a gentleman, but he doesn't take crap from anyone.	I am with a gentleman and he does not take anything from anyone.
and why aint he in jail	Why is he not incarcerated?
grrrrr  lol yes, he stood on a block of ice!	Yes, he stood on a block of ice.
the joker first appeared in comics in 1940 in batman #1	"The Joker first appeared in the comic, ""Batman #1,"" in 1940."
btw... i do believe it's sung in french.	By the way, I do believe it is sung in French.
Can't wait to ask my husband!!	I cannot wait to ask my husband!
the other thing you look for is (does he have very good feed back).	The other thing you for is does he give good feedback.
RAP..4everrr..  .. also i like metal, & rap/rock.. like Linkin park.. but plain rock SUCKS..	Rap forever, I also like metal, rap rock, such as Linkin Park. Plain rock is not my thing.
Oh, I don't know, says the guy.	"""Oh, I don't know,"" said the man."
you have to really listen to the song.	You have to listen to the song carefully.
a girl owns a chicken and goes to the rollercoaster with it.	A girls owns a chicken and goes on the roller coaster with it.
i don't no what r u talking about.	I'm sorry, I do not know what you are referring to.
and she's not a very good singer, either!	She is not the best singer.
Maya, hands down--she's sarcastic and down to earth.	I enjoy Maya because she is sarcastic and down to earth.
I just told ya what it was.	I just told you the answer.
There is one ZZ in ZZ Top.	There is one ZZ in ZZ Top.
Any movie Chuck Norris is in is a horror movie!	Any movie Chuck Norris is in is a horror movie!
i hope not cuz that looking freakin scary as sh*t	I hope not, because that is looking scary as ever
why post an old joke like that?	Why post an old joke like that?
they didnt do anything with it though, maybe its a future storyline.	They did not do anything with it though, maybe it is a future storyline?
INDEPEDENCE DAY... a little more sci fi but can be considered a disaster movie?	Independence Day is somewhat more science fiction but can also be considered a disaster film.
and no one ever had to worry about the god damn chicken ever again!	No one had to worry about the chicken any longer.
), gave him a cane with a bicycle horn attached to it... he thought it was hysterical.	I gave him a cane with a bicycle horn attached to it and he thought it was uproariously funny.
I think more people listen to rap nowadays.	I think more people listen to rap these days.
a little lovin', a box-o-wine, and that man-o-mine!	I am looking forward to a little love, some wine and spending time with my man.
I had that dream when I was like ten and I still remember it.	I can still recall a dream than I experienced when I was about ten years old.
you fool you already have a Star Wars name!	Didn't you realize that you already have a Star Wars name?
SHE'S PRETTY AND HAS GOOD MUSIC, IM A MUSIC FREAK I HAVE ALL HER AND DESTINY'S CHILD CD'S!	She is attractive and is a talented musician; I am a music fan and have all of her albums as well as those by Destiny's Child.
Cry, Cry Baby By Janis Joplin	"I enjoy Janis Joplin's rendition of ""Cry, Cry Baby."""
ok so is tht going to happen after 4000 years?	Is that going to happen after four thousand years?
I AM LOOKING FOR FEMALE IMPERSONATORER CLOTHES TO BUY  AND TOO LOOK AND OR VEIW	I am looking for female impersonator clothing for viewing and purchasing.
Hey check out this website they list alot of TV sitcoms on DVD	Check out this website, they list a lot of TV sitcoms on DVD.
Yo mama's so stupid, she put a phone up her ass and thought she was making a booty call.	Your mother is so stupid, she put her phone up her butt and thought she was making a promiscuous phone call.
I like maybe 2 songs but the rest sounds like poo.	I like two songs, but the rest is garbage.
But he is just too cute, plus he's old, i've just always liked old bald men.	I am fond of older men who do not have hair and he is cute.
It wasn't the most hilarious, but it was just great!	It wasn't the funniest, but it was a great moment.
How many girls played drums then?	How many women played the drums?
Chris is going all the way!!	Chris is going to be the winner.
and I like his music too.	I am fond of his music.
tell him u think ur pregnet but the kid is not his lol	tell him you think you are pregnant but the kid is not his.
national lampoons christmas vacation so funny.	National Lampoons Christmas Vacation is so funny.
Just like in the new HBO show Big Love	Just like in the new HBO show Big Love.
Flav is a LOT older than her.	Flav is a lot older than her.
yes i was good but now am evil	Yes I was good but now I am evil.
Have you ever seen Father of the Bride with Steve Martin in it???	Have you ever seen Father of the Bride with Steve Martin in it?
it was sung by a girl i need you more and more or something like that	It was sung by a girl I need you more and more or something like that.
wut r some good songs.no white songs like metallica.	What are some good songs, no white songs like Metallica.
it had to be the chickin.	It must have been the chicken.
I turned my ears away !	I stopped listening.
Beasty boys..haha.. seriously..umm..bone thugs and harmony	Beastie Boys. I am merely kidding. Bone Thugs-n-Harmony.
It's not that they are embarrassing as much as they suck and oh do they suck.	It is not that they are embarrassing as much as that they are very bad.
if Geeta is Ram then who is RAM?	If Geeta is Ram, then who is Ram?
ghost rider....he's from hell....i think he has a bit of evil in him	The ghost rider has a bit of evil in him as he is from hell.
and the blonde on the highway says,  it's blondes like you that make blondes like me  look so stupid.	The blonde insulted the other blond by mentioning how stupid she was on the highway.
you have 1 and 1/2 bricks  1.5 * 1.5 = 2.25	You have two one-and-a half bricks. Thus, one-and-a half times one-and-a half is two and a quarter.
i swore i seen that crazy guy who tried to frame tony last night on NCIS.	I think the crazy guy that tried to frame Tony made an appearance on last night's episode of NCIS.
How do you get a Catholic girl pregnant ?	How does a Catholic girl become pregnant.
How many songs, artists, and albums?	How many songs, artists, and albums?
I can pick up things with my toes...it really grosses out my husband	I can pick up things with my toes, it really grosses out my husband.
Shes definetly not the same anymore.	She is definitely not the same anymore.
so i guess yours is not the only one.	So I guess yours is not the only one.
I'm just askin because people act like they don't even care about them anymore.	I'm just asking because people act like they don't care about them anymore.
the year 1961 looks the same if you flip it upside down.	The year 1961, looks the same if you flip it upside down.
i want to know what people think because i sure feel that way :(	I want to know what people think because I sure feel that way.
U decide, but i would say Yes	You decide but I would say yes.
what kind of question is that!	What kind of question is that?
Can't you just see him in that awful green-striped rugby shirt?	Can you see him in that awful green-striped rugby shirt?
a few weeks later they get a postcard from him.	A few weeks later they got a postcard from him.
no, but my wife loves it.	I do not, but my wife loves it.
(if its an old car then roll down the window) if not unlock the door	If it is an old car then you should roll the window down; otherwise, unlock the door.
7th heaven has younger kids and problems and stuff like that.	Seventh Heaven has young children and other problems similar to that.
She has become pretty pathetic and she's just....there.	She has become pathetic, and she is there.
I still drum on my steering wheel and whatever else I can find!	I tap on my steering wheel and whatever else I can find!
no but peter gabriel was in genesis.	No, but Peter Gabriel was in Genesis.
hey hey hey hit me up!	Please get in touch when you can.
It just happens naturally, hey that has happened to me before...	It just happens naturally, it has happened to me before.
2 muffins are baking in an oven.	There are muffins baking in an oven.
Eeew, it has drool all over it!	That is gross, it has drool all over it!
Nice gnawing u  How do u stop burglers breakin in s ur house.	How do you stop burglars from breaking in your house?
how many hits has she had.	How many hits has she had?
id have to say... WIll farrell.	I would have to say WIll Farrell.
I think he's sexy as hell!!!	I think that he is extremely inviting.
Ahh I love the hair metal... Motley Crue, Poison, Cinderella, Faster Pussycat, Slaughter, etc.	I love the Hair Metal; Motley Crue, Poison, Cinderella, Faster Pussycat, Slaughter, etc.
oh favorite classic is the golden girls, is that considered classic?.....	My favorite classic is, The Golden Girls.  That is considered classic, correct?
yea they knew with out a doubt that you are a retarded moron with a serious LSD problem...	They were aware that you were unintelligent and had a drug problem.
Everyone gets a chance to ride her!	Everyone gets a chance to ride her.
at 60 its funny, at 80 not so much	It is funny at sixty, but it is not funny at eighty.
He is so easy to hate.	He makes it easy to hate him.
I knew you would ask that!	I knew that you would ask that.
ABBA of course...they ruled those days and even now i dont think so they have lost their popularity	ABBA of course because they were the best in the past. I do not think so, they have lost their popularity.
i need help on this reaserch project	I need help on this research project.
(i know how to read tabs)	I know how to read tablature.
so i am glad i have this to do.	I am pleased that this responsibility has fallen to me.
No, not if she survives, or any of her family.	"The answer is ""no"" with respect to her, if she survives, and all of her family members."
yes rudy ( i think thats her name )  cuz she is good student	I believe her name is Rudy, and she would be acceptable because she is a good student.
YES I LOVE IT BECAUSE I AM DISABLED DUE TO MY CROHN;S DISEASE IT GIVES ME SOMETHING TO DO.	I enjoy it because it provides me with an enjoyable activity and I am disabled due to Chron's disease.
I think she's adorable...in that trashy I'm gonna steal your man because I can...way.	I find her to be adorable in a way because she comes across as a man stealer.
i didn't even know they all existed.	I was not even aware they all existed.
dont know but i want that 2, like off the end of the movie, try searching online	I do not know, but I want that as well, from the end of the movie. Try searching online.
He used to be a hard rocker man!	He used to be a hard rock-and-roller.
shes just famous for her familys money	She's only famous because her family is wealthy.
I like Kirstie Alley... she's good, she's cool and just doesn't give a s*it about all that.	I admire Kirstie Alley. She's cool, she's a good actress, and she doesn't let little things bother her.
(ur name) is REALLY good acting,if she takes this seriously i think she can go far!	She's a great actress. I think she has a lot of potential.
is ther  a goos tool for mixing songs ?	What is a good tool for mixing songs?
It would just be Oh so wrong!	It would be very wrong.
She dies in episode 310 Losing the Light...it's so effin' sad!	"She dies in episode 310, ""Losing the Light""; It is very sad."
that wasn't a nice thing to do.	That was a less than professional way to approach the situation.
dude this riddle is old news.	I have heard this riddle before.
That said, Aerosmith, AC/DC, Van Halen, and Metallica have all done great stuff, too.	That said, Aerosmtih, AC/DC, Van Halen, and Metallica are all quite accomplished as well.
I DON'T CARE ABOUT THE QUESTION, BUT YOU ARE SO M~E~A~N!!!	I do not care about the question, but you are rather rude.
He's just incredible, I mean like took my breath away kind of stuff.	He is simply incredible, I mean to say that he is breath-taking.
He's soo hot i don't know why Hermione won't stay with him!	He is quite attractive, and I do not understand why Hermione will not stay with him.
He just gave his opponent that don't mess with me look and went at it.	He simply gave his opponent an intimidating glance and proceeded.
any movie with Jim Carrey in it!	Any movie with Jim Carrey in it.
guess it's better if you could sing that song infront of her......	It would be more preferable if you could sing the song in front of her.
I throw chili cheese dogs at my grandma all the time	I frequently propel deluxe frankfurters at my grandmother.
i tried to like him, but i just can't.	I attempted to enjoy his company but cannot.
yes i like their songs so much	Yes, I like their songs, a lot.
a chicken,a hyena and a jackal	It was a chicken, a hyena, and a jackal.
the third one was also good, but i felt it was too long.	The third one is also good. I felt it was too long.
i would use the baseball beat to break the window duhhhhhhhhh	I would use the baseball bat to break the window.
queen amadala and anakin of course	Queen Amadala and Anakin of course.
capricorn has the kind of drive that scorpio respects.	Capricorn has the kind of drive that Scorpio respects.
i like their music but WAY too many tatooes for me.	I like their music but way too many tattoos for me.
uh.... does gay still mean Happy ?	Does gay still mean happy?
A tomboy does not a lesbian make.	Tomboys are not lesbians.
Monk The Dukes of Hazzard Miami Vice Simpsons	I like Monk, The Dukes of Hazzard, Miami Vice, and the Simpsons.
I like almost all rock though.	I like almost all rock music, though.
the used's i caught fire(in your eyes)	"I love ""I Caught Fire"" by the Used."
I know ways in which they could have made it much worse.	I know the ways in whild they could have made it significantly worse.
Just turn it on and off.	Just turn it on and off.
LP stands 4 LINKIN PARK too...!	"LP also stands for ""Linkin Park."""
Well, what the hell do we have now??	Well, what do we have now?
2. dont whine about beig broken up with someone	Do not complain about being broken up with someone.
Rock... modern rap is disgusting and has no rhythm.	Rock. Modern rap is unappealing and has no rhythm.
Cant you just rhyme the words with themselves?	Can you not simply rhyme the words with themselves?
THE PARENTS STOP AND HIS MOM QUICKLY DISMOUNTS, PULLING THE COVERS AROUND HER.	The parents stop; his mother quickly gets down and pulls the covers around her.
Yo mama so stupid it takes her two hours to watch 60 Minutes.	"""Yo mama"" is so stupid, she takes two hours to watch ""60 Minutes."""
I've known people to pee in thier pants!	I have known people to urinate while still clothed.
My aunt just sent me a cd with an amazing tenor named Josh Groban.	My aunt recently sent me a CD with a wonderful tenor named Josh Groban.
Screw it back in and give it a try.	Reattach it and try it again.
They're all over the place there.	They are quite abundant here.
icy blue,and u can see it's breath and it will have icicles on it's nose	The color will be icy blue. You can see its breath, and there will be icicles on its nose.
lol just playin but they are super h-o-t	I am just teasing. However, they are very attractive.
I'd take magic over glow anyday!	I would take Magic over Glow any day.
Thanks so much if anybody can help!	If anyone is able to help, thank you so much.
no, i think they are stupid.	No, I believe that they are stupid.
Good luck trying to hack my lock!	I wish you luck in trying to hack my lock.
do u think 3 ppl in a band is a good amount??	Do you think that having three people in a band is a good amount?
salmon or some kind of fish?	Is is Salmon or some other kind of fish?
now you can get some sleep..	Now you are able to get sleep.
final destination was good (bad acting tho) but saw is still at the top of my list	Final Destination had a good plot woth bad acting. Saw is still my favorite.
He's so funny and he seems so sweet.	He is funny and appears sweet.
And you'll actually HAVE an experience to BACK IT UP!	You will have the experience to support it.
I love Tyra but I have to go with Angelina Jolie	I lie Tyra but feel that I must choose Angeline Jolie.
The Schindler's List ... the best movie i've ever seen ...	Schindler's List is an excellent motion picture.
YOUR WASTING YOUR TIME, SAYS THE BOY.	The boy tells the other he is wasting his time.
he wont say anything to the girl parrot.	He will not say anything to the female parrot.
'I just called to say 'I Love you'  is just great!	"I called to say ""I Love You"
Ask her out and treat her like a lady...tell her she's the one you're dreaming of.	Ask her out on a date, treat her like a lady, and tell her she is the one you have been dreaming of.
I wouldn't throw my chili cheese dog at her and she isn't going to beat me either!!!	I would not throw my chili cheese hotdog at her, but she is not going to beat me either!
But because of her, I'm writing music with a happy tone!	However, I am writing music with a happier tone because of her!
Tyra Banks I wouldnt know 4 sure because ive only seen Tyra Banks show	"Tyra Banks? I would not know for certain, since I have only seen the ""Tyra Banks Show."""
Orlando Bloom or Chad M Murray are both really sexy!	Orlando Bloom and Chad Michael Murray are both really attractive!
i think they are somewhat true i believe in ruling planets alot!	I believe they are true. I believe in ruling planets.
So if I download any In Flames song, the RIAA cannot sue me, right?	If I download songs by In Flames, will the RIAA be able to sue me?
i want 2 listen 2 good music but i dont knw wat 2 listen 2!!!!!!!!!!	I want to listen to music that I like but I am unaware of what to listen to.
um...well babysit i dont know good luck looking fir a job!!	I babysit, so I am unsure of the job market, but good luck in your search!
an evil fake b...h who should be put in jail for false advertising	That woman is utterly rude and dishonest. She should be prosecuted for false advertising.
never heard of em but the actual awards are so funny.	I have not heard of them, but the awards are quite funny.
Just play and have fun, and maybe you'll be lucky and win.	Simply enjoy yourself and perhaps you will get lucky and end up winning.
I have seen the movie too!	I have seen that movie as well!
Lord of the Rings: Return of the King...	Lord of the Rings: Return of the King.
say ur pregnant and say not from u from some1 else	Say that you are pregnant but claim that it is from someone else.
CHRIS AND KELLI ALL THE FREAKIN' WAY!	Absolutely, Chris and Kelli all of the way!
yea i heard they broke up too	Yes, I also heard that they broke up.
Yeah he is fucking hot and so is his music.	Yes he and his music are both very sexy.
The First Time Ever I Saw Your Face.	"I would say ""The First Time Ever I Saw Your Face."""
who sings the song I don't like the looks of it?	"Who sings the song ""I Don't Like the Looks of It""?"
I personally don't believe in them.	I personally do not believe in them.
Yo mama so stupid she called Dan Quayle for a spell check.	Your mother is so stupid that she called Dan Quayle for a spell check.
Im not a little scary beotch so i can do all the stuff that they do ya know.	I can do all the things that they do and I am not a scary little girl!
what the hell do u mean???	What do yu mean by that?
noo he siad that he liked her thats is what he rumor wass	There was a rumor going around that he said that he really liked her.
a genetic supercool monster full of charm and humour and good looks...smokin !	A genetic super cool monster full of charm and humor and good looks smoking!
at what maximum speed a couple make love?	at what maximum speed a couple make love?
i was reading an answer of yours & am impressed, youre cool.	I was reading an answer of yours and I am impressed, you are cool.
also he looks as creepy as hell	also he looks creepy as hell?
Shes jus a useless slob makin money over other ppl's troubles.	She is just a useless slob making money over other people's troubles.
it depends on the type of gum ur chewing	That would depend on the type of gum, or the chewing.
yeh, i know, that was lame	Of course, I know that was feeble.
i'm the only person in the entire country that doesn't think dave chappelle is funny.	I am probably the only person in this country who thinks Dave Chappelle is not funny.
The doc said  wot on earth have u been up to  ?	The doctor was startled and wanted to know what I have been doing.
One of you would have to sing.	Of course, one of you would need to be the singer.
Why don't you share where you're from?	Please tell me where you come from.
oprah of course cuz she gives better advice and has done it longer	It would be Oprah, of course, because she gives the best advice and has done so for a long time.
But all the same iv'e liked them since i was a kid!	But all the same, I have liked them since I was a child.
I LIKE HOW MAYA KEEPS IT REAL.	I like how real Maya keeps things.
Sell the baby to the movies	Selll the baby to the movies.
I think its a bit cheezy to name it though, but maybe I maybe name it Jet	I believe it should not have a name, however, if I had to pick on, I would pick Jet.
Did you ever hear the last song on the albulm Having a Roni??	Have you listened to the final song on the album Having a Roni?
mama so ugly, she scares buzzards off of a meat wagon.	Your mother is so unattractive she scared buzzards off of a meat wagon.
i want to make fullmetal alchemist videos	I want to make Fullmetal Alchemist Videos.
Beyonce can't sing, dance, or act and Rihanna(who?)	Beyonce cannot sing, dance, or act.  As for Rihanna, who is that?
just a dum funny question hahahaha	Just a senseless, funny question.
jerry, jerry, jerry........he must have picked up some skills after seeing all those fights up close!	Jerry must have picked up some skills after seeing all of those fights up close.
And people ?wonder why he's not married.	And people wonder why he is not married.
theres this song i have no clue wut it is.	There is this song and I have no clue what it is.
I reckon most girls actually think 'wow carmen electra looks good' and move on.	"I assume that most girls actually think ""Wow, Carmen Electra looks good"" and then move on."
paris hilton, but jessica is right under her	Paris Hilton, however Jessica is right beneath her.
i like oldies, old school rap, rap, pop, anything but hard rock.	The musical genres I enjoy are: oldies, classic rap, rap, pop, and anything besides hard rock.
I'm asking because only some have it and some don't, but I think its a little stupid.	I am asking simply because some have it while others do not, although it seems somewhat preposterous.
i think they make a cute couple... i am happy for them....	I think they are a good pairing and I wish them all the best.
Not at all, I really dont think in Spanish either...they rap about stupid stuff	No, I don't think in Spanish. They're rap music have ridiculous content.
im famous for inventing a hanger	I'm famous for my hangar invention.
and what is your question loser?	What's your question?
Can't think of the title (Take That First Step?)	I think the title might be, Take That First Step?
mix in some commonly known songs too.	Mix in some commonly know songs as well.
SOUNDS GOOD TO ME.HOW ABOUT THE REST OF YOU???	That is appealing to me but I'd like to have your reaction.
saw II very gorey i like it and mean girls and shark tale(i have kids)	Although Saw II is a very gory movie, I liked it and also enjoyed Mean Girls and, because I have children, Shark Tale.
anything's possible, all you gotta do is dream.	Anything is possible; all you have to do is use your imagination.
Even if you hate that kind of music you love Green Day.	Even if you very much dislike that kind of music, you love Green Day.
fav actress julia roberts fav actor jonny depp	My favorite actress is Julia Roberts; favorite actor is Jonny Depp.
but if it comes to wits, then george clooney would win.	If it comes to wits, then, George Clooney wins.
I'm not a Rock fan... but I hate George Clooney.	I do not like the Rock, but I really dislike George Clooney.
I dont really live here *ducks behind sofa*	"I duck behind the sofa as I say, ""I don't really live here""."
I met a girl, who's name was...Cherry Fudge.	I met a girl who's name was Cherry Fudge.
red hot chillis are way out front.	Red Hot Chili Peppers are on fire currently.
Its really fun to read, i think!	It's very fun to read I've heard.
monopoly, i love old style nintendo, mario bros and softball lol.	I enjoy original Nintendo, especially Super Mario Brothers.
well, uh there is no drink!!!!!	There is nothing to drink.
no he didnt die he is just old	He is just old, he did not die.
omg how does ur friends not know that show???!??!!!	How is it that your friends do not know that show.
hi Im Elvis you might of heard of me.	I am Elvis, have you heard of me?
Oh I did hear the Bjork-Chaney joke.	I heard the Bjork and Chaney joke.
i do not like nicole kidman all that much and i don't care if she came from here .	I do not like Nicole Kidman very much.  I also do not care if she came from here.
Yo mama so stupid she makes Beavis and Butt-Head look like Nobel Prize winners.	You mother is so doltish, she makes Beavis and Butt-Head look like Nobel Prize winners.
can anybody tell me wut the title of kill bill's song that include  bang.. bang.. (blablabla)	"Can anyone tell me the title of the ""Kill Bill"" song that includes bang, bang?"
I Am Sam and Hollywood Bollywood	"""I am Sam"" and ""Hollywood, Bollywood""."
Yo mama's so stupid, if brains were dynamite, she wouldn't have enough to blow her nose.	Your mother is unintelligent to the point that if brains were dynamite, she would not have enough to blow her nose.
Goo Goo Dolls and Relient K are awesome!	I enjoy listening to the Goo Goo Dolls and Relient K.
Hope you find this one funny!	I hope you enjoy this one.
limewire, i love it and it is great to get the latest music	"""Limewire"" is a great site to download the latest music."
taxes, gas, inflation and my ego!!	Taxes, inflation, gas, and my ego!
There's the key: You FELL ASLEEP!	The key is that you fell asleep!
Although all 3 are just one big movie.	Although the three are one big movie.
humm....blockbuster or any video store that sells childrens movies.	I imagine you could find it at Blockbuster or any video store that sells children's videos.
Fall Out Boy all the way!	You need to fall out, all the way!
I don't know who any of them are	I am not familiar with any of them.
She wanted kids and got married.. she did it and will not end up regretting it.	She wanted to have children and she got married and I don't think she will regret the decision.
one bottle of captain morgan..that'll do the trick...i am heading up north....meet ya at the library..???	One bottle of Captain Morgan should be sufficient; I am heading up north and could meet you at the library.
be creative and come up with something to challenge us	You must be creative and find something to challange us.
IT'S CHICO TIME -   'CHICO'  Thats majorly embarrassing...	That is very embarassing.
U2, Bon Jovi, Coldplay, and Three Doors Down	I love the rock bands U2, Bon Jovi, Coldplay, and Three Doors Down.
What is wrong with this girl?	What is wrong with this girl?
aCTUALY I HATE IT,CAN'T TAKE IT ANYMORE!	I dislike it, and I can not take it any longer.
example: shuichi likes to read manga everyday.	Shuichi likes to read manga books everyday.
don't call it a christian band!!!!	Don't refer to them as a Christian band.
It's very easy to pick up.	It's very easy to learn.
mine is the pleasure of my company by steve martin	"My personal favorite is ""The Pleasure of my Company"" by Steve Martin."
Gentleman, and I thank God everyday for the one that I have!	I like gentlemen, and I give thanks every day for the one I have.
just kidding, mc hammer, back when he had money and fame	I am kidding because I choose MC Hammer from when he had money and fame.
are you gay..people are so stupid..  did you see Donnie Darko?	People are unintelligent, but did you see the movie Donnie Darko?
I love the guitar and the drums!!	I am passionate about the guitar and drums!
Plus any movie Natalie Portman chooses is pretty good (she's picked some great roles so far).	Any move that Natalie Portman chooses is usually good because she has picked some great roles thus far.
the worst i've had is broken items.	The worst I've received was broken items.
i actually dont like them at all	Actually, I don't like them at all.
it's the best metal band ever!!	They're the greatest metal band ever.
I too own the Vanilla Ice cd>	I also own the Vanilla Ice CD.
U KNOW THEY ALWAYS THINK THAT THE STUPIDEST THINGS ARE FUNNY.	As you know, they always find the most ridiculous things humorous.
if so, who are you and why are you famous?	If so, who are you, and why are you famous?
I love her powers to freeze and blow things up!	I enjoy her powers such as freezing and causing explosions.
I actually made this one up, but I can't tell if people think it's funny or not.	I actually made this joke up.  I cannot tell if anyone thinks it is funny or not.
i think they both stink if i had to pick one it would be italian job.	"I think that both movies are bad.  If I am forced to choose one, it would be, ""The Italian Job""."
LOL  Girls need to be a little of everything.	That is funny.  Girls need to be a part of everything.
watching the baby cow suck on the mommy cow	Watching the calf suckle the mother.
It ended... you can get it on dvd if you want to see shawn lol.	You can get the movie on DVD if you want to see Shawn.
not really but that is just my opinion	I do not think so.
i used to like it but it totally freaks me out now.	It used to be something I enjoyed, but now I am repulsed by it.
That, to me made the movie a bit impressive.	That alone made the movie quite impressive.
dude, why are you wasting this question then?	Why then, are you wasting this question?
It is my fav TV programme, just 2nd to the Simpsons...	"It is my favorite television program, second only to ""The Simpson."""
Not long, if they were even really together at all.	If they were indeed together, it did not last long.
under the tuscan sun with diane lane	"The name of the film is ""Under the Tuscan Sun"" starring Diane Lane."
Im in my own little world and everybody likes me there.	I am in my own little world where everyone likes me.
Why do some men think it's funny when they fart?	Why do some men think it is funny when they fart?
I HOPE U GOT THE ANSWER THAT U WAS LOOKING 4.	I hope you got the answer that you were looking for.
WHEN YOU DONT MISS THAT PERSON ANYMORE, WHEN YOU SEE THAT OTHER PERSON YOUR EYES DONT LIGHT UP.	You know you do not miss a person when you see them and your eyes do not light up.
I don't know..never tried the stuff??	I have never tried it.
I dont know, but I hope they dont get married cause he dont deserve her.	I hope they do not get married because he does not deserve her.
was I suppose to pick one?	Was I supposed to pick one?
let's get together yeah yeah yeah !	Let us get together yeah!
I loved her in the 80's though!	I loved her in the 80s though!
do they erase it all the time?	do they erase it all the time?
my favorite english song is kiss from a rose by seal.	My favorite english song is a kiss from a rose by seal.
i like them both just want to see what yall think	I fancy both of them but I still want to know what all of your opinions are.
.....        Yeah I think I got it.	I think I have a grasp of what is going on.
anime is an animation version of a manga.	Anime is like manga in animation form.
mom is a taurus while dad is a scorpio.. they're still  happy together...  so i'd say YES!!	My mother's zodiac is Taurus whereas my father's is Scorpio and despite this they are still very happy together, therefore my answer is 'Yes.'
i can email it to you, if that doesnt work try limewire	"I can try emailing this it to you and if that does not work you can always try the application ""Limewire."""
If they don't like him fine.	If they do not like him, that is fine.
he just wishes he could tap that	He only wishes that he was able to have sex with you.
Probably ACDC, or Guns N Roses.	Probably AC/DC or Guns -N- Roses.
Been wanting to get back into it, cuz it was sounding pretty darn good, I think!	I have been wanting to try it again, because it sounded pretty good, in my opinion.
The American Rejects and the song is Dirty Little Secret	"The song is, ""Dirty Little Secret,"" by The American Rejects."
He didn't want to be a bigamist.	He did not want to be a bigamist.
The roommate rolled her eyes and said like duh, hello!	"The roommate rolled her eye and said, ""Hello."""
It's funny, but really, really stupid.	It is funny but very foolish.
She has awesome songs like Check Up On It, with Slim Thug.	"She has great songs like, ""Check Up On It,"" with Slim Thug."
so what are we supposed to do?	What are we supposed to do?
Note: i am not looking for aladdin movie.	"I am looking for the movie, ""Aladdin""."
and if they ask for cash only and no pay pal then they are going to scerw you.	If they only ask for cash and will not use PayPal, then you could be defraud you.
40 something too bad he retired	I believe he was in his forties. I also know that he retired.
Well, they probably can't see anything at first.	They may not be able to see anything to begin with.
I am glad someone finally asked this question!	I am happy that this question was finally asked.
no bee-otch i am a scorpio	Incorrect, I am a Scorpio.
I didnt know there was going to be an Incredibles 2??	I had no idea that there was going to be a sequel to Incredibles.
Eminem is one hot sexy son of a *****.	Eminem is a very attractive person.
He is a greasy looking little feller and he always seems to need a shave.	He is often dirty and always seems to need a shave.
List your best April Fools Pranks here	Record your best April Fools pranks here.
Drama Queens... Dunno, can't understand it myself.	Drama Queen, I can not understand it myself.
I need to know the name of the this movie from the 80's!	I need to know the name of a particular movie from the 1980s.
i used to be a fan too!	I also used to be a fan.
nothing short of a diamond ring	Nothing short of a diamond ring will do.
im not sure but these two points put me at 1001!	I am not certain, however these two points put me at 1,001.
I remember the days when you would have called what they have a fat arse not a booty.	"I remember the day that you would have said that someone had a large bottom, not a ""booty""."
I definitely don't want a thug.	"I definitely do not want a ""thug""."
Check it out on yahoo movies.	You should view it on Yahoo! Movies.
Any ideas how to do that?	Do you have any recommendations on how to proceed?
The Shield, The Sopranos, Twin Peaks, The Simpsons, Smallvill, Nip Tuck	The Shield, The Sopranos, Twin Peaks, The Simpsons, Smallville, and Nip/Tuck.
yes i actually bought one lmao	Hilariously, I actually purchased one.
i thought it was funny at first, but then it got old and stupid, damn altell.	I thought it was funny at first, but then it got old and stupid.
read numbers upside down and right side up	Read the numbers upside down and then right side up.
ya i think i am I have alot of people say I am to	I have alot of people who say I am too.
boss; what is her whole name?	What is the bosses whole name?
i love the parent trap....one of my favorite movies.	The Parent Trap is one of my favorite movies.
Your mama so ugly, Bigfoot takes pictures of her.	You're mother was able to get Bigfoot to take a picture of her.
its either a headstone or a coffin	It's either a coffin, or a headstone.
A genius can get people to buy into his idea, a stupid person can't.	A genius can get people to buy into his idea, most people can't.
I just don't understand Emo or Screamo.	I simply do not comprehend Emo or Screamo.
dead on arrival... there relationship is dead on arrival	Dead on arrival. Their relationship is classified as dead on arrival.
I don't really know bout the kids though.	I have no genuine knowledge regarding children, however.
No idea, I've tried to watch it, and just can't.	No knowledge whatsoever, I've attempted viewing, and I am simply unable.
The Click Five...they totally rock!their songs are out of this world!!	The Click Five is my favorite because their songs are out of this World.
and whats your fave bit in gilmore girls?	"What is your favorite scene in ""The Gilmore Girls""."
Just wondering though...how did that guy stay in one place during the entire film??	I was wondering, how did that man stay in one place during the entire film?
it is because life never wiorks out perfectly.	It is because life never works out perfectly.
hard to say but i'm thinking either kevin, bucky or melissa (just because she messed up the lyrics)	Hard to say, however, I am thinking either Keven, Bucky, or Melissa. Melissa got the lyrics incorrect.
No not funny but was made to be hated and remembered!	Negative, not humorous, but was created to be despised and recalled!
Its bugging me I want to hear it.	It's annoying me. I would like to listen to it.
and of course miracles can happen!!!	Additionally, as is to be expected, miraculous events may occur!
whether its country or classic  rock make sure people know the songs or they'll think u r weird.	If it's either country music or classic rock, be certain people are familiar with the selections or they'll consider you unusual.
If thats not 'hard' enough, System of a down rules!	See if that's not 'hard' enough.
i dont know abot the videos but you can download songs at itunes.com or limeware.com!!!!!!!!!!!!	I don't know about downloading videos on itunes.com or limeware.com
I must agree with American Idol!	I agree with American Idol!
not really, we are just not well understood.	We are just not well understood.
I found it and still do irresistible!!	I find it irresistible!
good lord yes its one of my favorite shows	Yes, that is one of my favorite shows.
i love green day i love all the songs exspecially boulvard of broken dreams	I love Green Day's songs, especially Boulevard of Broken Dreams.
Note: I did not know the Gameboy Micro had a rechargeable battery...	I have to say I did not know that the Gameboy Micro had a rechargeable battery.
I would have to say Will Farrell!	My choice would be Will Farrell.
my gosh...i'm gonna take a closer look to my disney's pictures...	Goodness, I am going to take a closer look at my Disney pictures.
((He is in She's the Man.))	"He is in ""She's the Man""."
u can try it cuz it is free... it will at least get u started	You can try because it is free. It will at least get you started.
why don't you throw a new life party?	Why do you not throw a new life themed party?
........Oh.... then no I'm not gay either.	Oh, then no, I am not gay, either.
But I cannot find anything on that.	But, I cannot find anything on that.
He said, If You're gonna play the game, boy, You gotta learn to play it right.	"He said, ""If you're gonna play the game, boy, you gotta learn to play it right."""
actually I'm watching it right now.	I am actually watching it right now.
Chuck Norris was in a horror flick back in the 70s or 80s.	Chuck Norris was in a horror film back in the 1970s or 1980s.
vanilla ice like you .. and Ok I admit i hav new kids on the block ...	Vanilla Ice, like you - and, all right, I admit I have New Kids on the Block.
Red Hot Chili Peppers of course.	The Red Hot Chili Peppers.
i say the same as every one else	I agree with everyone else.
Brad Pitt, Pippin, Johnny Depp- are definatly THE hottes men in the world!!!!	The most attractive men in the world are Brad Pitt, Pippin, and Johnny Depp.
But since you asked I think Rap Is Way BETTER!!!	I believe that Rap is better.
i m a handsome,dashing,cool person whom u can't get.	I am a handsome, dashing, cool man who does not want you.
flute, because that's what I can play.	I would say a flute because I can play that.
its ok. Its nothing great but its nothing bad.	It is fine, not good or bad but fine.
i want a him and will call him 'money'	"I want him and I will name him ""Money""."
And a bad boy 2 cuz da have every thang and their playful.	I say a bad boy also because they are so playful and have what it takes.
so u have to buy 2 packs of buns instead of one	So you will need to buy two packs of buns instead of one.
(Heck, I still like both bands now!)	In fact, I still enjoy both bands.
She also just did a spread in King Magazine!	She additionally completed a layout in King Magazine just recently!
tyra banks shes my idol i think shes pretty  but i heard a rumor that shes pregnant.	Tyra Banks, I idolize her. In my opinion, she's attractive, however there is a rumor circulating of her pregnancy.
i would go out there and kick your butt right now, but i can't swim.	I would travel to that location and physically assault you at this very moment, however, I am unable to swim.
Hmmmmmmmm...wow that's a tough one !	Hm, wow, that one is difficult!
it goes like this  wayoh wayoh wayoh wah.	It plays this way: wayoh, wayoh, wayoh, wah.
and if so, what's your opinion on it ?	If so, what is your opinion of it?
i am crazy bout boulevard of broken dreamz	"I deeply enjoy ""Boulevard of Broken Dreams""."
I don't think it is wierd at all.	I do not find it strange at all.
she took on armed guards at a palace in turkey!	She confronted armed guards at a Turkish palace.
he fired his sister because HE cant keep his mouth shut!	He fired his sister because he has loose lips.
abbie mitchell played clara in the first broadway production there have been five revivals see the rest here:	Abbie Mitchell played Clara in the first Broadway production, and there have been five revivals; you can see the rest here.
You r going to saint ives.	You are going to Saint Ives.
because he is a control freak!	He is a control freak.
but journey is completely friggin awesome.	Journey is completely awesome.
Whenever I think of her, I feel great.	I feel great whenever I think of her.
Ur right I cant answer it .....	I cannot answer it.
But I guess these days people would rather listen to songs with names like My Humps	Today, it seems people would rather listen to songs with weird names.
james both of them suck, rap is gay	James, I do not like rap music.
i just need some sick or ill rhymes about anything.	I need some good rhymes about anything.
And I'd have to say Riker and Troi.	I would have to say Riker and Troi.
they are not but thanks for your 2 points	They are not but thank you for your two points.
Hermionie, no, Tonks, NO WAIT, its Snape.	It is not Hermionie or Tonks but it is Snape.
i used to watch it until about season 4 just got to boring.	I watched it until season four and then I lost interest in it.
Oh yeah sister check this web site out.	Check this website out.
4ever by the Veronicas   Here we are so what you gonna do?	"""4Ever"" by The Veronicas. ""Here we are - so what you gonna do?"""
i used to be a fan too!	I used to be a fan as well.
sounds like my kind of girl!	She sounds like my kind of girl.
are bruce willis and mickey rourke the same person?	Are Bruce Willis and Mickey Rourke the same person?
there is one called DOC WATSON	"There is one called ""Doc Watson."""
when you find out please let me know	Please let me know when you find out.
I don't get why anyone likes that movie.	I do not understand why people like films of that sort.
it shuld be ffree to download  and easy to understsnd  features like looping, fading and like tht	It should be free to download and have easy to understand features.
however, it can also generally mean japanese comic books (like a genre).	It also is considered a form of Japanese comic book.
But I heard there is going to be a sequel.	I was informed that there is going to be a sequel.
Always loved his work, excellent actor!	I have always enjoyed his work, he is an excellent actor.
And sure enough he did just what he said.	In the end, he did follow through.
try being nice and talking to her, don't worry about your signs they aren't always right.	Try being nice and talking to her, but do not be concerend about your signs as they are not always correct.
i'm adding some new favs to my collection, why not try stained's new one right here waiting?	"I am adding a few new favorites to my collection, so, why not try Stained's new songs, ""Right Here Waiting?"""
i like the dude, he funny and down to earth.	I favor the man as he is humorous and grounded.
Yo mama so stupid that under Education on her job apllication, she put Hooked on Phonics.	"Your mother is rather unintelligent, that under ""Education"" on her job application, she writes ""Hooked on Phonics."""
I m confused r u lookin for some or one	I am confused, are you perusing for a few or simply one?
i would love to be her and have a lot of money.	I would like to be her and have a great deal of money.
But my sister is like obsessed with him!!!	My sister is obsessed with him.
5-7 mins...  no reason i guess.. im doing it pretty fast, am i?	I am workign pretty fast, maybe in 5-7 minuites.
He's rich and can look like that if he wants.	He is rich and can look like that is he wants to.
Don't try to impress her, if she likes you she will come to you!	Do not try to impress her. If she likes you, she will come to you.
rapp because u can ryhmn and spit crapbut in rock u cant make fun of people see	You can not make fun of people in rock music. But in rap, you need rhythm and rhyme.
there should be a category for best questions	A category should exist for most superior queries.
I havnet seen it yet but I really cant wait til its on dvd .	No, I have not seen it yet. I am waiting for it to be released on DVD.
It was just great, and made cry a lot ...	I found it phenomenal, even though it made me cry for quite a bit.
Don't you cry tonight by Guns 'n' Roses	"I like the song ""Don't You Cry Tonight"" by Guns 'n' Roses."
Damn...I think it's impossible to choose just one.	I think it is difficult to choose only one.
i just go high listerningh to them  :)	I just get high listening to them!
Yo mama so stupid that she thought Boyz II Men was a day care center.	Your mother is so stupid that she thought Boyz 2 Men was a daycare center.
bambi is my favorite movie of all time!!!!!!!	Bambi is my favorite movie of all time!
Then, of course Simon always disagrees...He's pretty good about his judgements, he's harsh, tho.	Then, of course Simon always disagrees, he is pretty good about his judgments, he is harsh though.
yes but they are unknown artists	Yes but they are unknown artists.
Umm..., don't know..., my head hurts...	I am unsure, as I am currently under the weather.
no, they broke up...i don't know how long ago though...	They ended their association at some unspecified time in the past.
lol i love watchin my lil guy try to act out the things wiht them	I enjoy watching my companion attempt to role-play with them.
THAT WAS NICE HOW YOU GOT HIM BACK.!!	It was positive how you retrieved him.
I just didn't think that he would jump again.	I was unwilling to admit the possibility that he might jump once again.
i don't HATE him... but he is weird   im amazed that this got 33 answer in 50 minutes... congrats	He is weird and I am amazed that he was able to get 33 answers in 50 minutes.
For me thats exactly what I'm looking for.If I were looking.	If I were looking, that is exactly what I would be looking for.
I even watch the reruns now!	Now, I watch the reruns.
Yea, I think Paula was like, LOVING everybody this week.... Was she on ecstasy or something?	Paula is loving on everyone this week, is she on something?
and she was willing to make a complete @$$ of herself for two whole seasons of newlyweds.	"She was willing to make a complete fool of herself for two entire seasons of ""Newlyweds."""
the song is fairly new sounds very old school	"The song is somewhat new, but sounds very ""old-school."""
at the disco i write sins not tragedies	"Panic! At the Disco, ""I Write Sins Not Tragedies."""
video killed the radio star by the buggles	"""Video Killed the Radio Star"" by the Buggles."
whats the difference between a mosquito and a blonde?	What differentiates a mosquitoo from a blonde?
So, no, I don't think so.	To the contary, I do not agree.
i think they are over-paid and definately over-celebrated.	I am of the opinion they are over-paid and definitely over-rated.
hands down this is the best movie in THE WORLD!!!!!!!!!!!	This is clearly an excellent motion picture.
But I think 4 ppl would be better!	However, I believe four peopld would be preferrable.
so dont worry youll be back in tune with it in a coupleof weeks!	Don't worry, You will be back in tune with it in a few weeks.
that was me before i had my operation.	I was like that before I had my operation.
there is a blonde driving down the highway.	A blonde is driving down the highway.
Eminems a poser,I pick Get rich or die tryin	Eminem's a fake. I pick Get Rich or Die Tryin'.
put parental control on or use web site ratings	You should put parental controls on or use web site ratings.
Plus you can tell she really cared about her crew.	Plus, you can tell she cared about her crew.
I LOOOOOVVVVVVVEEE this song SOOO Much!!!!!!	I love the song so much.
searching the web or looking for bugs!	Searching the internet or looking for bugs!
My favourite bands are The Used & Panic!	My favorite bands are The Used and Panic.
chicken, coz God can't lay eggs	Chicken, because God can not lay eggs.
to those of you asking if the asker of this question is gay.... Who the hell cares!?	To those of you who want to know if the questioner is gay, what does it matter?
All depends on who messes up?	It depends on who made the mistake.
um...neither of them...if i had to choose...i'd prob b mario..or vin diesel	If I had to choose, I would pick Mario or Vin Diesel.
Q: What did the left nut say to the right nut??	Q: What did the left nut say to the right nut?
its not a little racist..... its alot racist!!!!!!!!	"It is not ""a little racist"" - it is very racist."
It goes somethin like that for the chorus.	The chorus sounds something like that.
So it;s probally more than that.	It is probably more than that.
Ever wonder why men think a lot and women talk a lot??	Have you ever wondered why men think a lot and women talk a lot?
Your mama is so stupid after you were born she kept you!!	Your mother is so brainless, that after you were born she kept you.
The chicken because it had 2 hatch the egg	The chicken, because it has two hatched eggs.
Happy Days, it was the coolest!	"""Happy Days"" was the greatest show."
Her name aint Beyonce or Madonna... so she needs to stop pretending.	Her name is not Beyonce or Madonna. She needs to stop pretending.
I ask to peoples who gave answer for this question            WHERE IS YOUR JOCKS????!!!!	I ask people who give answers for this question. Where are your jocks?
Tell him you hate him and you r finding someone diffent.	Tell him you hate him and are finding someone else.
A lady in the street and a freak in the bed.	"""A lady in the street but a freak in the bed."""
I STILL never forgave her for that.)	I have still not forgiven her for that.
its a great source just download it.	It is a great source; you should download it.
The word you are looking for is.............  strengths	"The word you are seeking is ""strengths."""
You know, when I first got in to music, I loved rap.	When I first became interested in music, I loved rap.
I never told my parents before but mentioned it once and they said nothing and didn't care.	I never told my parents before; recently I mentioned it, and they did not comment, nor did they care.
Yeah, but you're gonna anyway so why even ask!!	You are going to anyway; why even ask?
I used to play flute but once I started sax, I got hooked.	I used to play the flute, but once I began playing saxophone, I was obsessed.
If you like Family Guy , you should love American Dad.	"If you like ""Family Guy,"" you should love ""American Dad."""
B) they right their own songs c) they ACTUALLY play their own music!	They write their own songs and actually play their own music.
we'll have a real good ti-ime!	We will have an enjoyable time.
Yeah, a PSP but I wouldn't get a PSP for a kid under 13.	Yes, a PlayStation Portable, but I would not purchase one for a child under the age of thirteen.
if you want to live and talk and dream about i suggest moving to japan or china	If you want to live, talk, and dream about it, then I suggest moving to Japan or China.
I LUBB IT.. [8] ILL KEEP U MY DIRRTY LITTLE SECRET ..hha...SHHH.....LMAO	I very much enjoy it. I will keep this unpleasant secret to myself.
I guess it is the blond from american idol	I believe that it is the blonde from American Idol.
(no offance) If you can answer that then it's the same for the Egg	No offence, but if you are able to answer that, then it is the same for the egg.
the song was called epic, i cant remember the artist but it is a banging tune!!	"The song was called ""Epic""; I can not remember the artist, but it is a great song!"
hey Mar...that commercial is for Dairy Queen...just thought i'd let ya know...lol.	Mar, I thought I would let you know that that commercial is for Dairy Queen.
